,neg_inst,query_name,pred_mask_size_foreground,pred_mask_size_background,y_mask_size_foreground,y_mask_size_background,intersection_size_foreground,intersection_size_background,wrong_pred_size_foreground,wrong_pred_size_background,union_foreground,union_background,IOU_foreground,percent_y_foreground,IOU_background,percent_y_background
0,True,2007_000129,108128,51872,0.0,51872,0,51872,108128,0,108128.0,51872,0.0,0.0,1.0,0.9999807221483238
1,False,2007_000323,124186,30905,120931.0,30905,118599,28573,5587,2332,126518.0,33237,0.9374081158412242,0.9807081665729501,0.8596744591870505,0.924513039539248
2,True,2007_000332,40487,119513,0.0,119513,0,119513,40487,0,40487.0,119513,0.0,0.0,1.0,0.9999916327794234
3,True,2007_000346,8,159992,0.0,159992,0,159992,8,0,8.0,159992,0.0,0.0,1.0,0.9999937497265505
4,True,2007_000762,30549,129451,0.0,129451,0,129451,30549,0,30549.0,129451,0.0,0.0,1.0,0.9999922751290053
5,True,2007_000762,26262,133738,0.0,133738,0,133738,26262,0,26262.0,133738,0.0,0.0,1.0,0.9999925227495345
6,False,2007_000783,25681,127630,26028.0,127630,23676,125278,2005,2352,28033.0,129982,0.8445760353868654,0.909600829843636,0.9638103737440569,0.9815640400843055
7,True,2007_000783,50619,109381,0.0,109381,0,109381,50619,0,50619.0,109381,0.0,0.0,1.0,0.9999908577279626
8,True,2007_000799,20654,139346,0.0,139346,0,139346,20654,0,20654.0,139346,0.0,0.0,1.0,0.9999928236704055
9,False,2007_000799,9735,144501,21000.0,144501,7617,131118,2118,13383,23118.0,157884,0.3294835193355827,0.3626970144278844,0.8304704719920954,0.9073784445890022
10,False,2007_000830,13087,137885,7054.0,137885,6032,136863,7055,1022,14109.0,138907,0.4275285278899993,0.8549964564138909,0.9852851188205058,0.9925808276402245
11,False,2007_000847,13958,141548,30133.0,141548,9672,121087,4286,20461,34419.0,162009,0.2810075830210058,0.32096635030198445,0.7474090945564753,0.8554422850037796
12,True,2007_000847,2962,157038,30133.0,157038,885,127790,2077,29248,32210.0,186286,0.027475939149332506,0.029368819273909868,0.685988211674522,0.8137469036354027
13,False,2007_000999,73552,81308,74205.0,81308,70659,77762,2893,3546,77098.0,84854,0.9164829178448208,0.9522006306767646,0.916421146911165,0.9563762929073042
14,True,2007_001175,2053,157947,0.0,157947,0,157947,2053,0,2053.0,157947,0.0,0.0,1.0,0.9999936688023907
15,True,2007_001239,23451,136549,0.0,136549,0,136549,23451,0,23451.0,136549,0.0,0.0,1.0,0.9999926766752105
16,True,2007_001284,1579,158421,0.0,158421,0,158421,1579,0,1579.0,158421,0.0,0.0,1.0,0.9999936877453889
17,False,2007_001311,9279,131840,18521.0,131840,9201,122520,78,9320,18599.0,141160,0.4947040163449648,0.49676060900550695,0.8679512609804477,0.9293012037226659
18,True,2007_001408,1804,158196,0.0,158196,0,158196,1804,0,1804.0,158196,0.0,0.0,1.0,0.9999936787676126
19,False,2007_001423,20700,133410,30058.0,133410,20181,123533,519,9877,30577.0,143287,0.6600058867776434,0.6713796200805083,0.8621368302776944,0.9259581293896305
20,True,2007_001430,11,159989,0.0,159989,0,159989,11,0,11.0,159989,0.0,0.0,1.0,0.9999937496093506
21,True,2007_001430,10419,149581,19052.0,149581,10022,140551,397,9030,19449.0,158611,0.5152964162681886,0.5260064031910985,0.8861365226875816,0.9396250885801768
22,True,2007_001526,78277,81723,0.0,81723,0,81723,78277,0,78277.0,81723,0.0,0.0,1.0,0.9999877636924281
23,False,2007_001585,14840,138198,10020.0,138198,8530,136708,6310,1490,16330.0,139688,0.5223515003061849,0.8512124538469215,0.978666743027318,0.9892112099219241
24,True,2007_001586,73089,86911,0.0,86911,0,86911,73089,0,73089.0,86911,0.0,0.0,1.0,0.9999884941089838
25,True,2007_001586,48036,111964,19396.0,111964,18755,111323,29281,641,48677.0,112605,0.38529490313700515,0.966902098262618,0.9886150703787576,0.9942660652882597
26,False,2007_001594,2444,151654,2652.0,151654,2279,151281,165,373,2817.0,152027,0.8090166844160455,0.8590275160196005,0.9950929769054181,0.9975338762322377
27,False,2007_001630,38252,104971,38596.0,104971,26182,92557,12070,12414,50666.0,117385,0.5167567994315715,0.6783428763893566,0.7884908633982195,0.8817303661928896
28,True,2007_001677,587,159413,0.0,159413,0,159413,587,0,587.0,159413,0.0,0.0,1.0,0.9999937270252299
29,False,2007_001678,7901,145109,12057.0,145109,7876,140928,25,4181,12082.0,149290,0.6518788280086079,0.6531763144800132,0.9439882108647598,0.9711804837709324
30,True,2007_001717,4477,155523,0.0,155523,0,155523,4477,0,4477.0,155523,0.0,0.0,1.0,0.9999935701242252
31,True,2007_001763,76259,83741,0.0,83741,0,83741,76259,0,76259.0,83741,0.0,0.0,1.0,0.9999880585608177
32,False,2007_001955,1471,156488,1919.0,156488,1368,155937,103,551,2022.0,157039,0.6765578635014837,0.7125,0.9929826348868752,0.9964725955178958
33,True,2007_002046,15888,144112,0.0,144112,0,144112,15888,0,15888.0,144112,0.0,0.0,1.0,0.9999930610007425
34,False,2007_002119,22542,125562,37739.0,125562,20349,108172,2193,17390,39932.0,142952,0.5095913052188721,0.5391891891891892,0.7567015501706866,0.8614958228140456
35,True,2007_002260,36760,123240,0.0,123240,0,123240,36760,0,36760.0,123240,0.0,0.0,1.0,0.9999918858172199
36,True,2007_002268,91591,68409,0.0,68409,0,68409,91591,0,91591.0,68409,0.0,0.0,1.0,0.9999853822540564
37,True,2007_002378,12745,147255,0.0,147255,0,147255,12745,0,12745.0,147255,0.0,0.0,1.0,0.9999932091052317
38,True,2007_002426,77128,82872,0.0,82872,0,82872,77128,0,77128.0,82872,0.0,0.0,1.0,0.9999879333437911
39,False,2007_002539,13873,143320,11664.0,143320,7601,139257,6272,4063,17936.0,147383,0.42378456735057984,0.6516073724817831,0.9448647401667764,0.9716440716991928
40,False,2007_002565,3640,145099,3741.0,145099,3441,144799,199,300,3940.0,145399,0.8733502538071066,0.9195617316942811,0.9958734241638526,0.9979255685733976
41,False,2007_002597,33990,118272,27860.0,118272,11518,101930,22472,16342,50332.0,134614,0.22884049908606852,0.4134094253616166,0.7572020740784763,0.8618196883481437
42,True,2007_002624,14055,145945,0.0,145945,0,145945,14055,0,14055.0,145945,0.0,0.0,1.0,0.9999931481506859
43,False,2007_002624,7166,147406,22803.0,147406,6682,131285,484,16121,23287.0,163527,0.2869412118349294,0.2930187686370812,0.8028337828003939,0.8906293459605039
44,False,2007_002643,6433,148077,5394.0,148077,4047,146730,2386,1347,7780.0,149424,0.5201799485861183,0.7501390176088971,0.981970767748153,0.9908966895825173
45,True,2007_002728,8272,151728,0.0,151728,0,151728,8272,0,8272.0,151728,0.0,0.0,1.0,0.999993409302111
46,True,2007_002823,13062,146938,0.0,146938,0,146938,13062,0,13062.0,146938,0.0,0.0,1.0,0.9999931944548418
47,True,2007_002823,8838,151162,0.0,151162,0,151162,8838,0,8838.0,151162,0.0,0.0,1.0,0.9999933846245443
48,False,2007_002824,92066,30495,81127.0,30495,64134,13502,27932,16993,109059.0,47488,0.5880670096003081,0.7905285474805246,0.28432446091644203,0.4427465897166842
49,False,2007_002852,42660,108679,56423.0,108679,40650,92906,2010,15773,58433.0,124452,0.6956685434600312,0.7204381114419396,0.7465207469546492,0.8548582995951417
50,True,2007_003011,5972,154028,0.0,154028,0,154028,5972,0,5972.0,154028,0.0,0.0,1.0,0.9999935077160794
51,False,2007_003020,563,145666,47290.0,145666,563,98939,0,46727,47290.0,192393,0.011905265383802072,0.011905013638958788,0.514254676625449,0.6792135487104148
52,False,2007_003022,20415,131438,16384.0,131438,15007,130061,5408,1377,21792.0,132815,0.6886472099853157,0.9158986878242295,0.9792643903173587,0.9895160492700036
53,False,2007_003022,18263,133590,1555.0,133590,1542,133577,16721,13,18276.0,133603,0.08437294812869336,0.9910025706940874,0.9998053935914613,0.999895202521128
54,False,2007_003088,37306,118430,45302.0,118430,36184,109312,1122,9118,46424.0,127548,0.7794244356367396,0.7987109021477606,0.8570263743845454,0.9230015789784769
55,True,2007_003106,10775,149225,0.0,149225,0,149225,10775,0,10775.0,149225,0.0,0.0,1.0,0.9999932987549086
56,True,2007_003110,7092,152908,0.0,152908,0,152908,7092,0,7092.0,152908,0.0,0.0,1.0,0.9999934601625804
57,True,2007_003134,11342,148658,0.0,148658,0,148658,11342,0,11342.0,148658,0.0,0.0,1.0,0.999993273195703
58,False,2007_003188,20143,119958,27507.0,119958,19357,111808,786,8150,28293.0,128108,0.6841621602516523,0.7036862003780718,0.8727636057076842,0.9320517843596562
59,True,2007_003194,36834,123166,0.0,123166,0,123166,36834,0,36834.0,123166,0.0,0.0,1.0,0.9999918809421354
60,False,2007_003367,3623,145628,4361.0,145628,3592,144859,31,769,4392.0,146397,0.8178506375227687,0.8234754699679047,0.9894943202388027,0.9947125915854672
61,True,2007_003367,11302,148698,0.0,148698,0,148698,11302,0,11302.0,148698,0.0,0.0,1.0,0.9999932750052118
62,True,2007_003373,126703,33297,0.0,33297,0,33297,126703,0,126703.0,33297,0.0,0.0,1.0,0.9999699681662563
63,True,2007_003373,107994,52006,0.0,52006,0,52006,107994,0,107994.0,52006,0.0,0.0,1.0,0.9999807718191782
64,False,2007_003530,39029,116372,27979.0,116372,26598,114991,12431,1381,40410.0,117753,0.6582034149962881,0.9506075768406004,0.9765441220181227,0.9881243931152415
65,True,2007_003621,7810,152190,0.0,152190,0,152190,7810,0,7810.0,152190,0.0,0.0,1.0,0.9999934293092233
66,True,2007_003742,6710,153290,0.0,153290,0,153290,6710,0,6710.0,153290,0.0,0.0,1.0,0.9999934764598052
67,True,2007_003742,0,160000,0.0,160000,0,160000,0,0,0.0,160000,0.0,0.0,1.0,0.9999937500390622
68,False,2007_003872,2920,155425,2595.0,155425,2453,155283,467,142,3062.0,155567,0.8011103853690399,0.9449152542372882,0.9981744200248125,0.9990799480138458
69,False,2007_004033,22876,58073,26191.0,58073,20761,52643,2115,5430,28306.0,63503,0.7334487387832969,0.7926466096518021,0.8289844574272082,0.9064813858180941
70,True,2007_004033,66170,93830,26191.0,93830,23216,90855,42954,2975,69145.0,96805,0.3357581893123147,0.8863775198533903,0.938536232632612,0.9682834031396873
71,False,2007_004112,53036,98737,17711.0,98737,16465,97491,36571,1246,54282.0,99983,0.3033233852842563,0.9295957542908763,0.9750757628796896,0.9873706171889243
72,False,2007_004112,75167,76606,50234.0,76606,37578,63950,37589,12656,87823.0,89262,0.4278833562961866,0.7480441922962078,0.7164302838833995,0.8347801114780634
73,False,2007_004121,6107,148426,11630.0,148426,5925,142721,182,5705,11812.0,154131,0.5016085336945479,0.5094144957441321,0.9259720627258631,0.961556859601016
74,True,2007_004189,13640,146360,0.0,146360,0,146360,13640,0,13640.0,146360,0.0,0.0,1.0,0.9999931675787949
75,True,2007_004275,5201,154799,0.0,154799,0,154799,5201,0,5201.0,154799,0.0,0.0,1.0,0.9999935400516796
76,True,2007_004275,29802,130198,0.0,130198,0,130198,29802,0,29802.0,130198,0.0,0.0,1.0,0.9999923194494581
77,False,2007_004281,3154,153752,3762.0,153752,3154,153144,0,608,3762.0,154360,0.8383838383838383,0.8381610417220303,0.9921223114796579,0.9960391016760649
78,True,2007_004380,3681,156319,0.0,156319,0,156319,3681,0,3681.0,156319,0.0,0.0,1.0,0.9999936028659161
79,False,2007_004380,24005,122371,27156.0,122371,12923,108138,11082,14233,38238.0,136604,0.3379622365186464,0.47586257686784256,0.7916166437293198,0.8836825417579185
80,True,2007_004392,11575,148425,0.0,148425,0,148425,11575,0,11575.0,148425,0.0,0.0,1.0,0.9999932626359264
81,False,2007_004405,48919,96710,23410.0,96710,18777,92077,30142,4633,53552.0,101343,0.35063116223483715,0.8020588612190851,0.9085679326643182,0.9520840442142052
82,False,2007_004538,35889,114548,20049.0,114548,16748,111247,19141,3301,39190.0,117849,0.42735391681551416,0.8353117206982543,0.9439791597722509,0.9711739081091935
83,True,2007_004538,8646,151354,0.0,151354,0,151354,8646,0,8646.0,151354,0.0,0.0,1.0,0.9999933930164183
84,True,2007_004644,25593,134407,0.0,134407,0,134407,25593,0,25593.0,134407,0.0,0.0,1.0,0.9999925599666687
85,False,2007_004712,7576,139127,17573.0,139127,6222,127776,1354,11351,18927.0,150478,0.3287367253130449,0.3540457494025265,0.8491340926912905,0.9184060721062619
86,True,2007_004712,1235,158765,0.0,158765,0,158765,1235,0,1235.0,158765,0.0,0.0,1.0,0.9999937014222189
87,False,2007_004722,14495,138114,3406.0,138114,2207,136915,12288,1199,15694.0,139313,0.14062699120683064,0.6477839741708248,0.9827869617336501,0.9913115881692792
88,True,2007_004722,56043,103957,0.0,103957,0,103957,56043,0,56043.0,103957,0.0,0.0,1.0,0.9999903807306797
89,False,2007_004902,33960,118286,38474.0,118286,33560,113372,400,4914,38874.0,123200,0.8633019498893862,0.8722547108512021,0.9202272727272728,0.9584485192793798
90,True,2007_004902,36448,123552,0.0,123552,0,123552,36448,0,36448.0,123552,0.0,0.0,1.0,0.9999919063074146
91,True,2007_005114,16076,143924,0.0,143924,0,143924,16076,0,16076.0,143924,0.0,0.0,1.0,0.9999930519367726
92,True,2007_005114,17040,142960,0.0,142960,0,142960,17040,0,17040.0,142960,0.0,0.0,1.0,0.999993005085303
93,False,2007_005149,62419,91765,61771.0,91765,60223,90217,2196,1548,63967.0,93313,0.9414698203761315,0.9749239137473289,0.9668213432212017,0.9831201098446047
94,True,2007_005173,65442,94558,0.0,94558,0,94558,65442,0,65442.0,94558,0.0,0.0,1.0,0.9999894245920536
95,True,2007_005173,65442,94558,0.0,94558,0,94558,65442,0,65442.0,94558,0.0,0.0,1.0,0.9999894245920536
96,False,2007_005281,2298,149907,7686.0,149907,1186,143407,1112,6500,8798.0,156407,0.13480336440100021,0.1542864576557825,0.9168835154436822,0.9566334018197828
97,False,2007_005304,83278,70475,78865.0,70475,70838,62448,12440,8027,91305.0,78502,0.7758392201960462,0.8982070854360561,0.7954956561616264,0.8860888813213008
98,True,2007_005331,29515,130485,6581.0,130485,6553,130457,22962,28,29543.0,130513,0.22181227363504044,0.9955940443634154,0.9995709239692597,0.9997777539352881
99,True,2007_005331,32195,127805,0.0,127805,0,127805,32195,0,32195.0,127805,0.0,0.0,1.0,0.9999921756412062
100,True,2007_005354,36,159964,0.0,159964,0,159964,36,0,36.0,159964,0.0,0.0,1.0,0.9999937486325133
101,False,2007_005354,4432,148059,6972.0,148059,4273,145360,159,2699,7131.0,150758,0.5992146963960174,0.6127921984798509,0.96419427161411,0.9817641496690531
102,True,2007_005509,13157,146843,0.0,146843,0,146843,13157,0,13157.0,146843,0.0,0.0,1.0,0.999993190052028
103,True,2007_005547,5310,154690,0.0,154690,0,154690,5310,0,5310.0,154690,0.0,0.0,1.0,0.9999935354998029
104,True,2007_005608,38260,121740,0.0,121740,0,121740,38260,0,38260.0,121740,0.0,0.0,1.0,0.9999917858404317
105,True,2007_005608,30259,129741,0.0,129741,0,129741,30259,0,30259.0,129741,0.0,0.0,1.0,0.9999922923956776
106,True,2007_005696,70647,89353,0.0,89353,0,89353,70647,0,70647.0,89353,0.0,0.0,1.0,0.9999888085592139
107,True,2007_005759,3265,156735,0.0,156735,0,156735,3265,0,3265.0,156735,0.0,0.0,1.0,0.9999936198448346
108,False,2007_005803,23827,131798,14456.0,131798,12505,129847,11322,1951,25778.0,133749,0.4851035766933044,0.8649789029535865,0.9708259501005615,0.9851895689648632
109,True,2007_005844,49387,110613,0.0,110613,0,110613,49387,0,49387.0,110613,0.0,0.0,1.0,0.9999909595530403
110,False,2007_005845,35200,120058,58922.0,120058,34893,96029,307,24029,59229.0,144087,0.5891201944993162,0.5921796242553842,0.6664653993767654,0.7998484078661325
111,True,2007_006028,11327,148673,0.0,148673,0,148673,11327,0,11327.0,148673,0.0,0.0,1.0,0.9999932738743829
112,True,2007_006076,9877,150123,0.0,150123,0,150123,9877,0,9877.0,150123,0.0,0.0,1.0,0.9999933388398924
113,True,2007_006086,32044,127956,0.0,127956,0,127956,32044,0,32044.0,127956,0.0,0.0,1.0,0.9999921848746063
114,True,2007_006117,110803,49197,0.0,49197,0,49197,110803,0,110803.0,49197,0.0,0.0,1.0,0.9999796739704866
115,False,2007_006171,37408,114211,38456.0,114211,36231,111986,1177,2225,39633.0,116436,0.9141624403905836,0.9421171698260394,0.9617815795801986,0.9805099289041431
116,True,2007_006171,43478,116522,38456.0,116522,36922,114988,6556,1534,45012.0,118056,0.8202701501821736,0.9600852900642276,0.97401233313004,0.9868266350849189
117,True,2007_006241,333,159667,0.0,159667,0,159667,333,0,333.0,159667,0.0,0.0,1.0,0.9999937370042838
118,False,2007_006364,48391,100205,44878.0,100205,40215,95542,8176,4663,53054.0,104868,0.7580012817129717,0.8960761157779807,0.9110691536026243,0.9534558808853761
119,True,2007_006364,47538,112462,0.0,112462,0,112462,47538,0,47538.0,112462,0.0,0.0,1.0,0.9999911081866925
120,False,2007_006373,3645,152562,3857.0,152562,3119,151824,526,738,4383.0,153300,0.7116130504220853,0.8084499740798341,0.9903718199608611,0.9951560994474414
121,False,2007_006444,6132,149629,6957.0,149629,6100,148772,32,857,6989.0,150486,0.8728001144655888,0.8766887036504742,0.9886102361681486,0.9942658557775848
122,False,2007_006444,9575,146186,11122.0,146186,9226,144290,349,1896,11471.0,148082,0.8042890768023712,0.8294524858401511,0.9743925662808444,0.9870234699391874
123,True,2007_006560,71040,88960,0.0,88960,0,88960,71040,0,71040.0,88960,0.0,0.0,1.0,0.9999887591191646
124,True,2007_006647,65776,94224,0.0,94224,0,94224,65776,0,65776.0,94224,0.0,0.0,1.0,0.999989387105333
125,False,2007_006647,15245,134150,26297.0,134150,13567,121420,1678,12730,27975.0,146880,0.48496872207327973,0.515894744847517,0.826661220043573,0.9050994774545102
126,True,2007_006698,1764,158236,0.0,158236,0,158236,1764,0,1764.0,158236,0.0,0.0,1.0,0.9999936803655276
127,False,2007_006802,14295,140932,2163.0,140932,1661,140430,12634,502,14797.0,141434,0.11225248361154289,0.7675600739371534,0.9929012825770324,0.9964309281715426
128,True,2007_006841,23459,136541,0.0,136541,0,136541,23459,0,23459.0,136541,0.0,0.0,1.0,0.9999926762461367
129,False,2007_006864,18365,109273,64325.0,109273,18167,63115,198,46158,64523.0,155431,0.28155851401825704,0.2824207940801542,0.4060644273021469,0.5775847868660432
130,False,2007_006866,28970,121146,23143.0,121146,21120,119123,7850,2023,30993.0,123169,0.6814441970767593,0.9125475285171103,0.9671508252888308,0.9832930241772392
131,False,2007_006866,19753,130363,4914.0,130363,3525,128974,16228,1389,21142.0,131752,0.16672973228644405,0.7171922685656155,0.9789149310826402,0.9893375471756006
132,True,2007_007007,35817,124183,0.0,124183,0,124183,35817,0,35817.0,124183,0.0,0.0,1.0,0.9999919474328416
133,True,2007_007007,38677,121323,31992.0,121323,9364,98695,29313,22628,61305.0,143951,0.15274447434956365,0.2926890257243772,0.6856152440761092,0.813482905278428
134,True,2007_007109,65631,94369,0.0,94369,0,94369,65631,0,65631.0,94369,0.0,0.0,1.0,0.9999894034121013
135,False,2007_007109,49835,101462,26681.0,101462,12090,86871,37745,14591,64426.0,116053,0.1876571570483966,0.45311445918596804,0.7485459229834645,0.8561840276751131
136,False,2007_007195,34969,119135,30662.0,119135,29045,117518,5924,1617,36586.0,120752,0.7938829060296289,0.947232821315592,0.9732178349012853,0.9864188826215418
137,True,2007_007203,0,160000,0.0,160000,0,160000,0,0,0.0,160000,0.0,0.0,1.0,0.9999937500390622
138,False,2007_007211,22813,133662,23935.0,133662,22668,132395,145,1267,24080.0,134929,0.9413621262458471,0.9470254010695187,0.9812197526106322,0.9905134554813224
139,True,2007_007235,30106,129894,0.0,129894,0,129894,30106,0,30106.0,129894,0.0,0.0,1.0,0.9999923014742677
140,True,2007_007417,3542,156458,0.0,156458,0,156458,3542,0,3542.0,156458,0.0,0.0,1.0,0.9999936085492046
141,True,2007_007493,11965,148035,0.0,148035,0,148035,11965,0,11965.0,148035,0.0,0.0,1.0,0.999993244886379
142,False,2007_007498,38781,105808,65189.0,105808,38316,78935,465,26873,65654.0,132681,0.583604959332257,0.5877588587206627,0.5949231615679713,0.746014044173936
143,False,2007_007498,50017,94572,74739.0,94572,32891,52724,17126,41848,91865.0,136420,0.3580362488434115,0.44007225046829007,0.38648292039290427,0.5574952682055132
144,True,2007_007651,14563,145437,0.0,145437,0,145437,14563,0,14563.0,145437,0.0,0.0,1.0,0.9999931242178798
145,True,2007_007651,13382,146618,0.0,146618,0,146618,13382,0,13382.0,146618,0.0,0.0,1.0,0.9999931796015523
146,True,2007_007688,77858,82142,0.0,82142,0,82142,77858,0,77858.0,82142,0.0,0.0,1.0,0.9999878261081285
147,False,2007_007748,21814,129210,13295.0,129210,13102,129017,8712,193,22007.0,129403,0.5953560230835643,0.9854091456077015,0.9970170707016066,0.9984985798422735
148,True,2007_007748,27254,132746,0.0,132746,0,132746,27254,0,27254.0,132746,0.0,0.0,1.0,0.9999924668730743
149,False,2007_007795,2338,137580,37595.0,137580,2061,102046,277,35534,37872.0,173114,0.05442015209125475,0.054819661666134695,0.589472832930901,0.7417157892441544
150,False,2007_007810,105367,50140,117649.0,50140,104210,36701,1157,13439,118806.0,63579,0.8771442519738061,0.8857628559286018,0.5772503499583196,0.7319558844059751
151,False,2007_007810,21168,134339,23856.0,134339,20612,131095,556,3244,24412.0,137583,0.8443388497460266,0.8639812214444398,0.9528430111278283,0.9758448712222718
152,False,2007_007815,51421,101659,4058.0,101659,4058,101659,47363,0,51421.0,101659,0.07891717391727116,0.9997536338999754,1.0,0.999990163289396
153,False,2007_007836,16703,128480,20259.0,128480,14684,122905,2019,5575,22278.0,134055,0.6591255947571595,0.7247778874629812,0.9168251836932603,0.9566005868572007
154,True,2007_007849,0,160000,0.0,160000,0,160000,0,0,0.0,160000,0.0,0.0,1.0,0.9999937500390622
155,True,2007_007996,5541,154459,0.0,154459,0,154459,5541,0,5541.0,154459,0.0,0.0,1.0,0.9999935258319306
156,True,2007_008110,6023,153977,0.0,153977,0,153977,6023,0,6023.0,153977,0.0,0.0,1.0,0.9999935055657302
157,False,2007_008204,7637,147894,8084.0,147894,0,139810,7637,8084,15721.0,155978,0.0,0.0,0.8963443562553693,0.9453328374860543
158,False,2007_008222,33022,121741,33701.0,121741,32694,120734,328,1007,34029.0,122748,0.9607687560610068,0.9700907957984689,0.9835924006908463,0.9917201951668282
159,False,2007_008256,18931,132916,18627.0,132916,17446,131735,1485,1181,20112.0,134097,0.867442322991249,0.9365471333476487,0.9823858848445528,0.9911072323329597
160,True,2007_008256,37552,122448,0.0,122448,0,122448,37552,0,37552.0,122448,0.0,0.0,1.0,0.9999918333346944
161,True,2007_008260,143044,16956,0.0,16956,0,16956,143044,0,143044.0,16956,0.0,0.0,1.0,0.9999410273043581
162,True,2007_008374,94791,65209,0.0,65209,0,65209,94791,0,94791.0,65209,0.0,0.0,1.0,0.9999846649286919
163,True,2007_008415,21085,138915,0.0,138915,0,138915,21085,0,21085.0,138915,0.0,0.0,1.0,0.9999928014051657
164,False,2007_008430,72404,75454,58165.0,75454,42923,60212,29481,15242,87646.0,90696,0.4897314195741962,0.7379396898531788,0.6638881538325836,0.7979855543038897
165,False,2007_008596,15035,139346,11570.0,139346,11117,138893,3918,453,15488.0,139799,0.7177815082644629,0.9607639789127992,0.9935192669475461,0.9967419463641126
166,False,2007_008596,5770,148611,4367.0,148611,3437,147681,2333,930,6700.0,149541,0.5129850746268657,0.7868589743589743,0.9875619395349771,0.9937353645735203
167,False,2007_008708,23061,132150,32176.0,132150,23017,122991,44,9159,32220.0,141309,0.7143699565487275,0.7153246107468068,0.8703691909220219,0.9306853523620706
168,False,2007_008802,27451,123527,15685.0,123527,15396,123238,12055,289,27740.0,123816,0.5550108147080028,0.9815121764630881,0.9953317826452155,0.9976523541221424
169,True,2007_008897,665,159335,0.0,159335,0,159335,665,0,665.0,159335,0.0,0.0,1.0,0.9999937239544108
170,False,2007_008944,86190,69899,99815.0,69899,80280,50364,5910,19535,105725.0,89434,0.7593284464412391,0.8042798749699447,0.5631415345394369,0.7205150214592275
171,True,2007_008964,62150,97850,0.0,97850,0,97850,62150,0,62150.0,97850,0.0,0.0,1.0,0.9999897803803742
172,True,2007_008964,75337,84663,0.0,84663,0,84663,75337,0,75337.0,84663,0.0,0.0,1.0,0.9999881886043654
173,True,2007_008980,53408,106592,0.0,106592,0,106592,53408,0,53408.0,106592,0.0,0.0,1.0,0.999990618520916
174,False,2007_009068,2906,147365,16808.0,147365,1472,132029,1434,15336,18242.0,162701,0.08069290647955268,0.08757213397584628,0.8114824125235862,0.8959257902094105
175,False,2007_009084,7993,135497,9886.0,135497,7377,132988,616,2509,10502.0,138006,0.7024376309274424,0.7461312835035906,0.9636392620610698,0.9814757413393556
176,True,2007_009084,38851,121149,9886.0,121149,5174,116437,33677,4712,43563.0,125861,0.11877051626380185,0.5233134418933953,0.9251237476263497,0.9610978126289723
177,False,2007_009251,19332,134267,14423.0,134267,13864,133708,5468,559,19891.0,134826,0.6969986426021819,0.9611758180809762,0.9917078308338154,0.9958292370482915
178,True,2007_009251,25896,134104,14423.0,134104,14018,133699,11878,405,26301.0,134509,0.5329835367476522,0.9718524681087077,0.9939780981198284,0.9969725215316356
179,True,2007_009258,71418,88582,0.0,88582,0,88582,71418,0,71418.0,88582,0.0,0.0,1.0,0.9999887111522527
180,False,2007_009320,19371,132108,35357.0,132108,18165,114916,1206,17192,36563.0,149300,0.4968137187867516,0.513745121330392,0.7696985934360349,0.8698574661832275
181,False,2007_009331,7850,143642,8140.0,143642,7062,142564,788,1078,8928.0,144720,0.790994623655914,0.867460999877165,0.98510226644555,0.9924883217420968
182,True,2007_009331,10292,149708,8140.0,149708,6189,147757,4103,1951,12243.0,151659,0.5055133545699584,0.7602260164598944,0.9742712268971838,0.9869613717278186
183,False,2007_009331,6060,145432,8121.0,145432,5746,143057,314,2375,8435.0,147807,0.6812092471843509,0.7074612164491505,0.9678634976692578,0.9836625800196654
184,False,2007_009413,66479,65076,36206.0,65076,24683,53553,41796,11523,78002.0,76599,0.3164406040870747,0.6817190046123678,0.6991344534523949,0.8229174670006301
185,False,2007_009413,71833,59722,54855.0,59722,46326,51193,25507,8529,80362.0,68251,0.5764664891366567,0.8445019687910165,0.7500695960498748,0.8571739530834017
186,False,2007_009521,14718,141564,3932.0,141564,3759,141391,10959,173,14891.0,141737,0.25243435632261096,0.9557589626239512,0.997558859013525,0.9987708826334193
187,False,2007_009562,66594,88546,69022.0,88546,66585,86109,9,2437,69031.0,90983,0.964566643971549,0.9646784405198268,0.9464295527735951,0.9724665996589382
188,False,2007_009592,27155,127013,26405.0,127013,26070,126678,1085,335,27490.0,127348,0.9483448526736995,0.9872756191774597,0.9947388258943995,0.997354622325098
189,True,2007_009654,19408,140592,0.0,140592,0,140592,19408,0,19408.0,140592,0.0,0.0,1.0,0.9999928872703477
190,True,2007_009655,103765,56235,0.0,56235,0,56235,103765,0,103765.0,56235,0.0,0.0,1.0,0.9999822177964294
191,True,2007_009684,15776,144224,0.0,144224,0,144224,15776,0,15776.0,144224,0.0,0.0,1.0,0.9999930663893223
192,False,2007_009687,68734,82669,85035.0,82669,61491,59125,7243,23544,92278.0,106213,0.6663668480027742,0.7231172679806199,0.556664438439739,0.715192935768719
193,False,2007_009691,36596,116314,29280.0,116314,25884,112918,10712,3396,39992.0,119710,0.6472294458891779,0.8839862026570131,0.9432628853061565,0.9707948243992607
194,True,2007_009691,24424,135576,0.0,135576,0,135576,24424,0,24424.0,135576,0.0,0.0,1.0,0.9999926241176601
195,True,2007_009706,15521,144479,0.0,144479,0,144479,15521,0,15521.0,144479,0.0,0.0,1.0,0.9999930786267995
196,True,2007_009750,20570,139430,0.0,139430,0,139430,20570,0,20570.0,139430,0.0,0.0,1.0,0.9999928279937746
197,False,2007_009756,36619,117534,23293.0,117534,22795,117036,13824,498,37117.0,118032,0.6141390737397958,0.9785781746372456,0.9915616104107361,0.9957544561194538
198,False,2007_009756,35366,118787,13733.0,118787,13635,118689,21731,98,35464.0,118885,0.3844743965711708,0.9927916120576671,0.9983513479412878,0.9991665824830791
199,True,2007_009841,15124,144876,0.0,144876,0,144876,15124,0,15124.0,144876,0.0,0.0,1.0,0.9999930975931307
200,False,2007_009938,17585,135537,14450.0,135537,13435,134522,4150,1015,18600.0,136552,0.7223118279569892,0.9296934468202892,0.9851338684164275,0.9925039472325105
201,True,2008_000080,24252,135748,0.0,135748,0,135748,24252,0,24252.0,135748,0.0,0.0,1.0,0.99999263346323
202,False,2008_000213,28362,128162,61411.0,128162,27935,94686,427,33476,61838.0,161638,0.4517448817878974,0.4548785253696346,0.5857904700627328,0.7387935675663023
203,True,2008_000215,10290,149710,0.0,149710,0,149710,10290,0,10290.0,149710,0.0,0.0,1.0,0.9999933204640942
204,False,2008_000223,0,132066,7844.0,132066,0,124222,0,7844,7844.0,139910,0.0,0.0,0.8878707740690444,0.9405983326644809
205,True,2008_000233,0,160000,0.0,160000,0,160000,0,0,0.0,160000,0.0,0.0,1.0,0.9999937500390622
206,True,2008_000234,11643,148357,0.0,148357,0,148357,11643,0,11643.0,148357,0.0,0.0,1.0,0.9999932595478505
207,False,2008_000239,18719,138758,20080.0,138758,18637,137315,82,1443,20162.0,140201,0.9243626624342823,0.9280912305164085,0.9794152680794003,0.9895934678110969
208,False,2008_000270,19104,129792,14122.0,129792,10299,125969,8805,3823,22927.0,133615,0.44920835695904393,0.7292359980174183,0.9427758859409497,0.9705377023414206
209,True,2008_000270,61244,98756,0.0,98756,0,98756,61244,0,61244.0,98756,0.0,0.0,1.0,0.9999898741355043
210,True,2008_000271,29,159971,0.0,159971,0,159971,29,0,29.0,159971,0.0,0.0,1.0,0.9999937489060585
211,False,2008_000359,96730,58366,114350.0,58366,96525,40541,205,17825,114555.0,76191,0.8426083540657326,0.8441115512763334,0.5320969668333531,0.6945876951016842
212,False,2008_000474,12400,143679,12354.0,143679,10055,141380,2345,2299,14699.0,145978,0.6840601401455881,0.8138405503844597,0.968502103056625,0.9839922048997772
213,False,2008_000510,9796,145521,10398.0,145521,8323,143446,1473,2075,11871.0,147596,0.7011203773902789,0.8003654197518992,0.971882706848424,0.985734115803796
214,True,2008_000573,3100,156900,0.0,156900,0,156900,3100,0,3100.0,156900,0.0,0.0,1.0,0.9999936265543241
215,False,2008_000573,0,144560,79701.0,144560,0,64859,0,79701,79701.0,224261,0.0,0.0,0.2892121233741043,0.4486618105851509
216,False,2008_000602,51568,103728,49991.0,103728,49832,103569,1736,159,51727.0,103887,0.963365360450055,0.9967994879180669,0.9969389817782783,0.9984575191123023
217,False,2008_000630,12383,142175,12936.0,142175,11978,141217,405,958,13341.0,143133,0.8978337455962822,0.9258715312669089,0.986613848658241,0.9932548390726986
218,False,2008_000661,25910,126272,20996.0,126272,20287,125563,5623,709,26619.0,126981,0.7621247980765619,0.9661856455684146,0.9888329750120096,0.994377261964157
219,False,2008_000661,20363,131819,23033.0,131819,7367,116153,12996,15666,36029.0,147485,0.20447417358239195,0.3198315533559087,0.787558056751534,0.8811485358822637
220,True,2008_000662,13300,146700,0.0,146700,0,146700,13300,0,13300.0,146700,0.0,0.0,1.0,0.9999931834138827
221,False,2008_000666,8233,147805,8546.0,147805,8197,147456,36,349,8582.0,148154,0.9551386623164764,0.959049959049959,0.9952886860968991,0.997632031176001
222,False,2008_000673,57134,88155,40433.0,88155,33587,81309,23547,6846,63980.0,95001,0.5249609252891528,0.8306623138942474,0.8558752013136703,0.9223308680067154
223,True,2008_000700,2204,157796,0.0,157796,0,157796,2204,0,2204.0,157796,0.0,0.0,1.0,0.9999936627439051
224,True,2008_000725,25513,134487,0.0,134487,0,134487,25513,0,25513.0,134487,0.0,0.0,1.0,0.9999925643923622
225,True,2008_000731,112387,47613,0.0,47613,0,47613,112387,0,112387.0,47613,0.0,0.0,1.0,0.999978997773764
226,False,2008_000763,17173,139113,122466.0,139113,14982,31629,2191,107484,124657.0,246597,0.12018578980723105,0.12233499636636808,0.12826190099636248,0.22736029443478012
227,True,2008_000763,67616,92384,122466.0,92384,60892,30810,6724,61574,129190.0,153958,0.47133679077327967,0.49721149370850926,0.20011951311396614,0.33349569735346646
228,False,2008_000765,10187,147212,14522.0,147212,8167,140857,2020,6355,16542.0,153567,0.4937129730383267,0.562349376850513,0.9172348225855815,0.9568244652306522
229,True,2008_000782,40653,119347,0.0,119347,0,119347,40653,0,40653.0,119347,0.0,0.0,1.0,0.9999916211415357
230,True,2008_000795,18,159982,0.0,159982,0,159982,18,0,18.0,159982,0.0,0.0,1.0,0.9999937493358669
231,False,2008_000811,61182,88263,41181.0,88263,40739,87821,20443,442,61624.0,88705,0.6610898351291704,0.989242873099898,0.9900343836311369,0.9949809661923321
232,False,2008_000811,52149,97296,16725.0,97296,12581,93152,39568,4144,56293.0,101440,0.22349137548185388,0.752182231256726,0.9182965299684542,0.9573984809398028
233,True,2008_000863,14941,145059,0.0,145059,0,145059,14941,0,14941.0,145059,0.0,0.0,1.0,0.999993106300841
234,True,2008_000943,56859,103141,0.0,103141,0,103141,56859,0,56859.0,103141,0.0,0.0,1.0,0.9999903046285703
235,False,2008_000992,31731,124455,46144.0,124455,31585,109896,146,14559,46290.0,139014,0.6823287967163534,0.6844728572976487,0.7905390823945789,0.8830108632769814
236,True,2008_001013,93496,66504,0.0,66504,0,66504,93496,0,93496.0,66504,0.0,0.0,1.0,0.9999849635365762
237,False,2008_001028,4064,154019,7041.0,154019,4050,151028,14,2991,7055.0,157010,0.5740609496810772,0.5751207043453564,0.9619005158907076,0.9805739514348786
238,False,2008_001070,13911,143843,13815.0,143843,13609,143637,302,206,14117.0,144049,0.9640150173549621,0.985017371163868,0.9971398621302473,0.9985609410194377
239,False,2008_001074,52252,102697,41966.0,102697,36922,97653,15330,5044,57296.0,107741,0.6444079865959229,0.8797864989158148,0.9063680493034221,0.9508753821885528
240,True,2008_001076,30512,129488,0.0,129488,0,129488,30512,0,30512.0,129488,0.0,0.0,1.0,0.9999922773362988
241,True,2008_001150,3606,156394,0.0,156394,0,156394,3606,0,3606.0,156394,0.0,0.0,1.0,0.9999936059336936
242,True,2008_001170,23201,136799,0.0,136799,0,136799,23201,0,23201.0,136799,0.0,0.0,1.0,0.9999926900584796
243,False,2008_001231,5215,149934,3826.0,149934,3409,149517,1806,417,5632.0,150351,0.6052911931818182,0.8907760648027175,0.9944529800267374,0.9972121252542768
244,True,2008_001249,30678,129322,0.0,129322,0,129322,30678,0,30678.0,129322,0.0,0.0,1.0,0.9999922674234282
245,False,2008_001283,38061,94786,56374.0,94786,32794,71206,5267,23580,61641.0,118366,0.532016028292857,0.5817117516629712,0.6015747765405607,0.7512211590196968
246,True,2008_001308,18422,141578,0.0,141578,0,141578,18422,0,18422.0,141578,0.0,0.0,1.0,0.9999929368055998
247,False,2008_001379,26509,130268,26581.0,130268,26260,129947,249,321,26830.0,130589,0.9787551248602311,0.98788653976375,0.9950838125722687,0.9975281916649394
248,False,2008_001404,30945,118929,20791.0,118929,20283,118421,10662,508,31453.0,119437,0.6448669443296347,0.9755194305502116,0.9914934233110343,0.9957201715294711
249,True,2008_001478,9940,150060,0.0,150060,0,150060,9940,0,9940.0,150060,0.0,0.0,1.0,0.9999933360433424
250,True,2008_001491,27326,132674,0.0,132674,0,132674,27326,0,27326.0,132674,0.0,0.0,1.0,0.999992462785001
251,False,2008_001504,41683,112946,42977.0,112946,41370,111339,313,1607,43290.0,114553,0.9556479556479557,0.9625855088650007,0.9719431180327011,0.9857632340832426
252,False,2008_001531,19773,131870,16898.0,131870,15875,130847,3898,1023,20796.0,132893,0.7633679553760339,0.93940469850287,0.9846041552226227,0.9922348355589933
253,False,2008_001547,9266,148488,10112.0,148488,9179,147555,87,933,10199.0,149421,0.8999901951171684,0.9076436270147336,0.9875117955307486,0.9937099717824216
254,False,2008_001629,40733,114938,46735.0,114938,38309,106512,2424,8426,49159.0,123364,0.7792876177302224,0.8196893187264636,0.8633961285302033,0.9266828491634693
255,False,2008_001682,8435,148549,9525.0,148549,8404,147428,31,1121,9556.0,149670,0.8794474675596484,0.8822170900692841,0.985020378165297,0.9924469875462807
256,True,2008_001821,90120,69880,0.0,69880,0,69880,90120,0,90120.0,69880,0.0,0.0,1.0,0.999985689958644
257,True,2008_001874,5293,154707,0.0,154707,0,154707,5293,0,5293.0,154707,0.0,0.0,1.0,0.9999935362101507
258,True,2008_001895,76534,83466,70294.0,83466,57619,70791,18915,12675,89209.0,96141,0.6458877467520093,0.8196742300305854,0.7363247729896715,0.8481315969185427
259,True,2008_001895,118286,41714,0.0,41714,0,41714,118286,0,118286.0,41714,0.0,0.0,1.0,0.999976027807743
260,True,2008_001992,75527,84473,0.0,84473,0,84473,75527,0,75527.0,84473,0.0,0.0,1.0,0.9999881620380235
261,False,2008_001992,22406,128758,37220.0,128758,13481,105019,8925,23739,46145.0,152497,0.292144327662802,0.36218801214368235,0.6886627277913664,0.815624538867186
262,False,2008_002212,11476,141919,6825.0,141919,6230,141324,5246,595,12071.0,142514,0.5161129980946069,0.9126867858189276,0.9916499431634787,0.9958004509582864
263,True,2008_002239,28778,131222,0.0,131222,0,131222,28778,0,28778.0,131222,0.0,0.0,1.0,0.9999923793847115
264,False,2008_002240,65888,73261,79443.0,73261,62056,55874,3832,17387,83275.0,90648,0.7451936355448814,0.7811288454760587,0.6163842555820316,0.7626600420408943
265,True,2008_002241,6962,153038,0.0,153038,0,153038,6962,0,6962.0,153038,0.0,0.0,1.0,0.9999934657178889
266,True,2008_002379,38069,121931,0.0,121931,0,121931,38069,0,38069.0,121931,0.0,0.0,1.0,0.9999917987074763
267,False,2008_002383,30150,122470,32005.0,122470,29605,120070,545,2400,32550.0,124870,0.9095238095238095,0.9249828157220521,0.9615600224233203,0.9803953589012909
268,False,2008_002495,4197,147258,14741.0,147258,4144,136661,53,10597,14794.0,157855,0.2801135595511694,0.28110161443494774,0.8657375439485604,0.9280315634358511
269,True,2008_002536,19788,140212,0.0,140212,0,140212,19788,0,19788.0,140212,0.0,0.0,1.0,0.9999928679936954
270,False,2008_002588,30284,127854,33142.0,127854,30211,124923,73,2931,33215.0,130785,0.9095589342164685,0.9115348640738618,0.9551783461406125,0.9770677720855657
271,False,2008_002775,9867,143296,45688.0,143296,6503,104111,3364,39185,49052.0,182481,0.1325735953681807,0.14233185230580664,0.570530630586198,0.7265399833911387
272,False,2008_002775,6857,146306,17202.0,146306,34,129138,6823,17168,24025.0,163474,0.0014151925078043704,0.0019763994652095564,0.7899604830125891,0.8826508642785376
273,False,2008_002835,26521,128569,23802.0,128569,22468,127235,4053,1334,27855.0,129903,0.8066056363309998,0.943914632609335,0.979461598269478,0.9896165512950144
274,False,2008_002835,38692,116398,7976.0,116398,6818,115240,31874,1158,39850.0,117556,0.17109159347553324,0.8547072834398897,0.9802987512334547,0.9900428697841047
275,False,2008_002859,43060,102526,44226.0,102526,41826,100126,1234,2400,45460.0,104926,0.920061592608887,0.9457118954484817,0.9542534738768275,0.9765817784583574
276,True,2008_002864,10385,149615,0.0,149615,0,149615,10385,0,10385.0,149615,0.0,0.0,1.0,0.9999933162228639
277,False,2008_002864,49743,100520,58888.0,100520,48519,90151,1224,10369,60112.0,110889,0.8071433324461006,0.8239059926302026,0.8129841553264977,0.8968374767461526
278,False,2008_002904,28225,128187,28888.0,128187,28077,127376,148,811,29036.0,128998,0.9669720347155255,0.9718924157984008,0.987426161645917,0.9936655537179767
279,True,2008_002929,1440,158560,0.0,158560,0,158560,1440,0,1440.0,158560,0.0,0.0,1.0,0.9999936932789274
280,True,2008_002936,1094,158906,0.0,158906,0,158906,1094,0,1094.0,158906,0.0,0.0,1.0,0.999993707011019
281,False,2008_002942,59716,97963,96545.0,97963,41944,43362,17772,54601,114317.0,152564,0.3669095585083583,0.4344457564269882,0.28422170367845623,0.44263198726062636
282,True,2008_002958,33456,126544,0.0,126544,0,126544,33456,0,33456.0,126544,0.0,0.0,1.0,0.9999920976727646
283,False,2008_003034,13027,137192,20948.0,137192,12447,128691,580,8501,21528.0,145693,0.5781772575250836,0.594157239009022,0.8833025608642832,0.9380289081804465
284,False,2008_003076,516,152672,40591.0,152672,492,112573,24,40099,40615.0,192771,0.01211375107718823,0.012120614899487583,0.5839726929880532,0.737347140620804
285,True,2008_003108,13852,146148,0.0,146148,0,146148,13852,0,13852.0,146148,0.0,0.0,1.0,0.9999931576678596
286,True,2008_003141,24031,135969,0.0,135969,0,135969,24031,0,24031.0,135969,0.0,0.0,1.0,0.9999926454364934
287,True,2008_003210,6418,153582,0.0,153582,0,153582,6418,0,6418.0,153582,0.0,0.0,1.0,0.9999934888626997
288,True,2008_003238,58784,101216,26255.0,101216,1480,76441,57304,24775,83559.0,125991,0.01771203580703455,0.056368068251066425,0.6067179401703297,0.7552189849531206
289,True,2008_003238,57560,102440,0.0,102440,0,102440,57560,0,57560.0,102440,0.0,0.0,1.0,0.9999902382834998
290,True,2008_003330,47318,112682,0.0,112682,0,112682,47318,0,47318.0,112682,0.0,0.0,1.0,0.9999911255468882
291,False,2008_003333,19908,129092,9608.0,129092,9329,128813,10579,279,20187.0,129371,0.4621290929806311,0.9708606514725778,0.9956868231674796,0.9978310210468422
292,True,2008_003333,22754,137246,9608.0,137246,9301,136939,13453,307,23061.0,137553,0.4033216252547591,0.9679467166198356,0.9955362660210973,0.9977558708022762
293,True,2008_003379,2951,157049,3246.0,157049,2122,155925,829,1124,4075.0,158173,0.5207361963190184,0.6535263319987681,0.9857877134529913,0.9928366762177651
294,True,2008_003451,24311,135689,0.0,135689,0,135689,24311,0,24311.0,135689,0.0,0.0,1.0,0.9999926302601518
295,True,2008_003451,20612,139388,15221.0,139388,14454,138621,6158,767,21379.0,140155,0.6760840076710791,0.949546708711076,0.9890549748492741,0.9944902395454448
296,True,2008_003461,22510,137490,0.0,137490,0,137490,22510,0,22510.0,137490,0.0,0.0,1.0,0.9999927267966631
297,True,2008_003461,40995,119005,0.0,119005,0,119005,40995,0,40995.0,119005,0.0,0.0,1.0,0.999991597062333
298,True,2008_003477,21566,138434,0.0,138434,0,138434,21566,0,21566.0,138434,0.0,0.0,1.0,0.9999927763932531
299,True,2008_003492,62143,97857,0.0,97857,0,97857,62143,0,62143.0,97857,0.0,0.0,1.0,0.9999897811114064
300,False,2008_003511,5559,148043,7811.0,148043,5386,145618,173,2425,7984.0,150468,0.6745991983967936,0.689452124935996,0.9677672329000186,0.9836129799248872
301,False,2008_003511,31329,122273,50127.0,122273,28757,100903,2572,21370,52699.0,143643,0.5456839788231276,0.573671401212895,0.7024567852244802,0.8252204066277377
302,False,2008_003546,3800,97028,29905.0,97028,3800,70923,0,26105,29905.0,123133,0.12706905199799365,0.12706480304955528,0.5759869409500297,0.7309464180811922
303,True,2008_003576,25912,134088,0.0,134088,0,134088,25912,0,25912.0,134088,0.0,0.0,1.0,0.9999925422667034
304,True,2008_003676,3851,156149,0.0,156149,0,156149,3851,0,3851.0,156149,0.0,0.0,1.0,0.9999935959013769
305,False,2008_003733,45916,102159,74278.0,102159,36291,64172,9625,37987,83903.0,140146,0.4325351894449543,0.48857685213855867,0.45789391063605095,0.6281519185591229
306,True,2008_003782,13621,146379,0.0,146379,0,146379,13621,0,13621.0,146379,0.0,0.0,1.0,0.9999931684656373
307,False,2008_003856,18469,77357,20629.0,77357,18469,75197,0,2160,20629.0,79517,0.8952930340782393,0.8952496364517692,0.9456719946678069,0.9720649448020889
308,False,2008_003874,12749,125084,93781.0,125084,12749,44052,0,81032,93781.0,206116,0.13594438105799683,0.13594293147938838,0.2137243105823905,0.35217651996642285
309,True,2008_004101,19188,140812,0.0,140812,0,140812,19188,0,19188.0,140812,0.0,0.0,1.0,0.9999928983829618
310,False,2008_004140,45376,107813,37766.0,107813,33419,103466,11957,4347,49723.0,112160,0.6721034531303421,0.8848730373077025,0.9224857346647646,0.9596712857328362
311,True,2008_004140,10425,149575,0.0,149575,0,149575,10425,0,10425.0,149575,0.0,0.0,1.0,0.9999933144354709
312,True,2008_004175,8959,151041,0.0,151041,0,151041,8959,0,8959.0,151041,0.0,0.0,1.0,0.999993379324956
313,False,2008_004345,59845,90425,57313.0,90425,56490,89602,3355,823,60668.0,91248,0.931133381683919,0.9856230589384792,0.9819612484657197,0.9908875765819565
314,True,2008_004396,53703,106297,0.0,106297,0,106297,53703,0,53703.0,106297,0.0,0.0,1.0,0.9999905924852772
315,False,2008_004399,6677,151065,4116.0,151065,4046,150995,2631,70,6747.0,151135,0.599673929153698,0.9827544328394462,0.9990736758527144,0.9995300067520156
316,True,2008_004399,7784,152216,0.0,152216,0,152216,7784,0,7784.0,152216,0.0,0.0,1.0,0.999993430431555
317,True,2008_004575,9800,150200,53517.0,150200,8620,105303,1180,44897,54697.0,195097,0.15759548055652048,0.1610673044583131,0.5397468951342153,0.7010805520602392
318,False,2008_004575,25622,123535,53517.0,123535,24989,95007,633,28528,54150.0,152063,0.46147737765466296,0.4669270152098359,0.6247870948225407,0.7690632690066054
319,False,2008_004624,15109,139966,16038.0,139966,14878,138806,231,1160,16269.0,141126,0.9144999692667035,0.9276139410187667,0.9835607896489662,0.9917051876513749
320,True,2008_004654,6634,153366,0.0,153366,0,153366,6634,0,6634.0,153366,0.0,0.0,1.0,0.9999934796925023
321,True,2008_004687,25360,134640,0.0,134640,0,134640,25360,0,25360.0,134640,0.0,0.0,1.0,0.9999925728418535
322,True,2008_004705,66977,93023,0.0,93023,0,93023,66977,0,66977.0,93023,0.0,0.0,1.0,0.9999892500859993
323,False,2008_005049,25135,130866,14581.0,130866,13040,129325,12095,1541,26676.0,132407,0.4888289098815415,0.8942531888629818,0.9767232850226951,0.9882170447859276
324,True,2008_005089,10572,149428,0.0,149428,0,149428,10572,0,10572.0,149428,0.0,0.0,1.0,0.9999933078585816
325,False,2008_005145,71968,85682,154100.0,85682,71779,3361,189,82321,154289.0,168003,0.46522435170362114,0.4657919156916568,0.020005595138182057,0.039225984150881736
326,False,2008_005197,15727,131421,13976.0,131421,11956,129401,3771,2020,17747.0,133441,0.6736913281117936,0.855405308721471,0.9697244475086367,0.984622057189816
327,False,2008_005197,7545,139603,17814.0,139603,5715,127504,1830,12099,19644.0,151702,0.2909285277947465,0.32079708111142297,0.8404899078456447,0.9133262657230452
328,True,2008_005245,25410,134590,0.0,134590,0,134590,25410,0,25410.0,134590,0.0,0.0,1.0,0.9999925700826949
329,True,2008_005245,39659,120341,0.0,120341,0,120341,39659,0,39659.0,120341,0.0,0.0,1.0,0.9999916903491716
330,True,2008_005399,19045,140955,0.0,140955,0,140955,19045,0,19045.0,140955,0.0,0.0,1.0,0.9999929055875593
331,True,2008_005422,44005,115995,0.0,115995,0,115995,44005,0,44005.0,115995,0.0,0.0,1.0,0.9999913790130694
332,False,2008_005445,11541,131168,26608.0,131168,8577,113137,2964,18031,29572.0,149199,0.290037873664277,0.32233454846104703,0.758295967131147,0.862528493775206
333,False,2008_005525,25769,130016,24825.0,130016,24280,129471,1489,545,26314.0,130561,0.9227027437865775,0.9780069282204141,0.9916514119836705,0.9958005491589561
334,False,2008_005637,33262,120401,32667.0,120401,32330,120064,932,337,33599.0,120738,0.9622310187803208,0.9896534835312845,0.9944176646954562,0.9971927376621651
335,True,2008_005642,19926,140074,0.0,140074,0,140074,19926,0,19926.0,140074,0.0,0.0,1.0,0.999992860967339
336,True,2008_005691,44222,115778,0.0,115778,0,115778,44222,0,44222.0,115778,0.0,0.0,1.0,0.9999913628550946
337,True,2008_005738,730,159270,0.0,159270,0,159270,730,0,730.0,159270,0.0,0.0,1.0,0.9999937213930973
338,True,2008_005812,6037,153963,0.0,153963,0,153963,6037,0,6037.0,153963,0.0,0.0,1.0,0.999993504975189
339,False,2008_005915,69826,80123,111447.0,80123,65459,34135,4367,45988,115814.0,126111,0.5652080059405599,0.5873501543320652,0.2706742472900857,0.42602715790524687
340,True,2008_006008,1514,158486,0.0,158486,0,158486,1514,0,1514.0,158486,0.0,0.0,1.0,0.999993690334223
341,False,2008_006036,4006,154359,3433.0,154359,3101,154027,905,332,4338.0,154691,0.714845550945136,0.9030285381479325,0.995707571869081,0.9978427053640839
342,False,2008_006108,13418,139888,17687.0,139888,12049,134250,1369,5638,19056.0,145526,0.6322942905121747,0.6811962912709182,0.9225155642290724,0.959689468078262
343,False,2008_006108,46562,106744,50228.0,106744,43415,99931,3147,6813,53375.0,113557,0.8133957845433255,0.8643413167691971,0.8800073971661808,0.9361656283666683
344,True,2008_006130,42050,117950,0.0,117950,0,117950,42050,0,42050.0,117950,0.0,0.0,1.0,0.9999915219031632
345,True,2008_006216,9086,150914,0.0,150914,0,150914,9086,0,9086.0,150914,0.0,0.0,1.0,0.9999933737534373
346,True,2008_006219,19112,140888,0.0,140888,0,140888,19112,0,19112.0,140888,0.0,0.0,1.0,0.9999929022137996
347,True,2008_006254,47824,112176,0.0,112176,0,112176,47824,0,47824.0,112176,0.0,0.0,1.0,0.9999910855166388
348,False,2008_006275,2564,144071,61046.0,144071,2564,85589,0,58482,61046.0,202553,0.04200111391409757,0.04200042590135469,0.4225511347647282,0.5940710200455328
349,False,2008_006341,71670,82082,19369.0,82082,18682,81395,52988,687,72357.0,82769,0.2581920201224484,0.9644811564274651,0.9833995819690947,0.9916182400740714
350,False,2008_006408,40505,112679,46128.0,112679,35511,102062,4994,10617,51122.0,123296,0.6946324478698016,0.7698194194541395,0.8277803010641059,0.9057685481008164
351,False,2008_006408,65045,88139,40522.0,88139,40454,88071,24591,68,65113.0,88207,0.6212891434890114,0.9982972632825803,0.9984581722539028,0.9992171545268891
352,True,2008_006526,2176,157824,0.0,157824,0,157824,2176,0,2176.0,157824,0.0,0.0,1.0,0.9999936638682084
353,True,2008_006526,8293,151707,0.0,151707,0,151707,8293,0,8293.0,151707,0.0,0.0,1.0,0.9999934083898014
354,True,2008_006554,3453,156547,0.0,156547,0,156547,3453,0,3453.0,156547,0.0,0.0,1.0,0.9999936121828449
355,False,2008_006722,23398,126882,24105.0,126882,16312,119089,7086,7793,31191.0,134675,0.5229713699464589,0.6766780054758151,0.8842695377761277,0.9385733313367433
356,False,2008_006722,38199,112081,50357.0,112081,35066,96790,3133,15291,53490.0,127372,0.6555617872499533,0.6963342467929624,0.7599001350375278,0.8635641762281187
357,True,2008_006874,52355,107645,46719.0,107645,37812,98738,14543,8907,61262.0,116552,0.6172178511965003,0.8093321917808219,0.8471583499210653,0.9172472734704494
358,True,2008_006874,19581,140419,0.0,140419,0,140419,19581,0,19581.0,140419,0.0,0.0,1.0,0.9999928785073351
359,True,2008_006981,42748,117252,0.0,117252,0,117252,42748,0,42748.0,117252,0.0,0.0,1.0,0.9999914714335667
360,False,2008_007048,11614,141553,6711.0,141553,6319,141161,5295,392,12006.0,141945,0.52632017324671,0.9414481525625745,0.9944767339462468,0.997223674357489
361,True,2008_007219,14311,145689,0.0,145689,0,145689,14311,0,14311.0,145689,0.0,0.0,1.0,0.9999931361109204
362,False,2008_007378,13790,129429,11296.0,129429,124,118257,13666,11172,24962.0,140601,0.004967550677029084,0.010976365406745153,0.8410822113640728,0.9136753457467357
363,True,2008_007378,12782,147218,0.0,147218,0,147218,12782,0,12782.0,147218,0.0,0.0,1.0,0.9999932073985015
364,False,2008_007392,13853,141282,11670.0,141282,10882,140494,2971,788,14641.0,142070,0.7432552421282699,0.9323965384285837,0.9889068768916731,0.9944154639977917
365,False,2008_007392,3582,151553,3311.0,151553,1900,150142,1682,1411,4993.0,152964,0.38053274584418184,0.5736714975845411,0.9815512146648885,0.9906831888303839
366,False,2008_007402,13043,135657,19172.0,135657,12604,129089,439,6568,19611.0,142225,0.6427005252154403,0.6573827778647056,0.9076393039198453,0.9515767592032907
367,True,2008_007402,35870,124130,0.0,124130,0,124130,35870,0,35870.0,124130,0.0,0.0,1.0,0.9999919439946509
368,False,2008_007513,30721,124420,26968.0,124420,25627,123079,5094,1341,32062.0,125761,0.7992951157133055,0.9502391634840002,0.9786738337004318,0.9892140394306428
369,False,2008_007737,51737,98840,52668.0,98840,49327,95499,2410,3341,55078.0,102181,0.8955844438795889,0.9365471150012341,0.9346062379503038,0.9661881203144445
370,True,2008_007828,569,159431,0.0,159431,0,159431,569,0,569.0,159431,0.0,0.0,1.0,0.9999937277334537
371,True,2008_007945,71513,88487,0.0,88487,0,88487,71513,0,71513.0,88487,0.0,0.0,1.0,0.9999886990326372
372,True,2008_007994,16142,143858,0.0,143858,0,143858,16142,0,16142.0,143858,0.0,0.0,1.0,0.9999930487491224
373,True,2008_008051,4321,155679,0.0,155679,0,155679,4321,0,4321.0,155679,0.0,0.0,1.0,0.9999935765673176
374,False,2008_008127,10921,143997,6818.0,143997,6775,143954,4146,43,10964.0,144040,0.6179314118934696,0.9935474409737498,0.9994029436267703,0.9996944402005583
375,False,2008_008127,10821,144097,3808.0,144097,3792,144081,7029,16,10837.0,144113,0.34991233736273875,0.9955368863218692,0.9997779520237592,0.9998820247331677
376,False,2008_008221,6661,144679,7404.0,144679,6295,143570,366,1109,7770.0,145788,0.8101673101673101,0.850101282916948,0.9847861278020139,0.9923278960464473
377,True,2008_008335,7647,152353,0.0,152353,0,152353,7647,0,7647.0,152353,0.0,0.0,1.0,0.9999934363390525
378,True,2008_008335,13741,146259,0.0,146259,0,146259,13741,0,13741.0,146259,0.0,0.0,1.0,0.9999931628606591
379,False,2008_008362,17952,123624,24480.0,123624,17429,116573,523,7051,25003.0,130675,0.6970763508378994,0.7119398717372656,0.8920834130476373,0.9429565217391305
380,False,2008_008362,23461,118115,47633.0,118115,22908,93390,553,24725,48186.0,142840,0.4754077947951687,0.48091699206449173,0.6538084570148418,0.7906634156253175
381,True,2008_008392,19828,140172,0.0,140172,0,140172,19828,0,19828.0,140172,0.0,0.0,1.0,0.9999928659584941
382,True,2008_008393,103981,56019,0.0,56019,0,56019,103981,0,103981.0,56019,0.0,0.0,1.0,0.999982149232417
383,False,2008_008421,65099,87797,64495.0,87797,64181,87483,918,314,65413.0,88111,0.9811658233072936,0.9951159761845696,0.9928726265732996,0.9964122189571516
384,True,2008_008469,71814,88186,0.0,88186,0,88186,71814,0,71814.0,88186,0.0,0.0,1.0,0.9999886604601586
385,True,2009_000012,27138,132862,0.0,132862,0,132862,27138,0,27138.0,132862,0.0,0.0,1.0,0.9999924734500952
386,False,2009_000074,55259,96806,39729.0,96806,39572,96649,15687,157,55416.0,96963,0.7140897935614263,0.9960231563050591,0.9967616513515465,0.9983678866197693
387,True,2009_000074,60876,99124,0.0,99124,0,99124,60876,0,60876.0,99124,0.0,0.0,1.0,0.9999899117276166
388,True,2009_000156,8329,151671,0.0,151671,0,151671,8329,0,8329.0,151671,0.0,0.0,1.0,0.9999934068252545
389,False,2009_000219,60987,92573,30930.0,92573,22799,84442,38188,8131,69118.0,100704,0.3298561879684019,0.7370922375610229,0.8385168414362886,0.9121567610776243
390,False,2009_000309,10795,132774,21563.0,132774,10795,122006,0,10768,21563.0,143542,0.5006260724389,0.5006028566128733,0.8499672569700855,0.918892863867445
391,False,2009_000412,47706,92777,47216.0,92777,45505,91066,2201,1711,49417.0,94488,0.9208369589412551,0.9637418726306203,0.9637837609008552,0.9815473495871866
392,False,2009_000418,31016,122071,35027.0,122071,5227,92271,25789,29800,60816.0,151871,0.08594777690081558,0.149223478360169,0.6075616806368562,0.7558735828035913
393,False,2009_000421,6412,148694,4588.0,148694,3296,147402,3116,1292,7704.0,149986,0.42782969885773625,0.7182392678143387,0.9827717253610337,0.991304347826087
394,False,2009_000457,15717,130229,7623.0,130229,6733,129339,8984,890,16607.0,131119,0.4054314445715662,0.8831322140608604,0.9864245456417453,0.9931582584657913
395,False,2009_000704,8232,134748,31401.0,134748,7275,110622,957,24126,32358.0,158874,0.22482848136473205,0.23167314183809948,0.6962876241549908,0.8209485784681148
396,True,2009_000705,9874,150126,0.0,150126,0,150126,9874,0,9874.0,150126,0.0,0.0,1.0,0.9999933389730029
397,False,2009_000727,16807,135844,7950.0,135844,7913,135807,8894,37,16844.0,135881,0.46978152457848493,0.9952207269525846,0.999455405833045,0.999720269424712
398,True,2009_000730,32239,127761,0.0,127761,0,127761,32239,0,32239.0,127761,0.0,0.0,1.0,0.9999921729465725
399,False,2009_000730,27581,126956,9737.0,126956,9724,126943,17857,13,27594.0,126969,0.3523954482858592,0.9985623331279524,0.9997952256062503,0.9998897264428114
400,True,2009_000825,11857,148143,0.0,148143,0,148143,11857,0,11857.0,148143,0.0,0.0,1.0,0.9999932498109947
401,True,2009_000825,27645,132355,0.0,132355,0,132355,27645,0,27645.0,132355,0.0,0.0,1.0,0.9999924446190577
402,True,2009_000839,150407,9593,0.0,9593,0,9593,150407,0,150407.0,9593,0.0,0.0,1.0,0.9998957681884512
403,True,2009_000892,14988,145012,0.0,145012,0,145012,14988,0,14988.0,145012,0.0,0.0,1.0,0.999993104066532
404,True,2009_000931,9307,150693,0.0,150693,0,150693,9307,0,9307.0,150693,0.0,0.0,1.0,0.999993364035728
405,True,2009_000935,75071,84929,0.0,84929,0,84929,75071,0,75071.0,84929,0.0,0.0,1.0,0.999988225597551
406,True,2009_001215,5432,154568,6539.0,154568,0,148029,5432,6539,11971.0,161107,0.0,0.0,0.9188241355124234,0.9576887991770665
407,True,2009_001215,302,159698,0.0,159698,0,159698,302,0,302.0,159698,0.0,0.0,1.0,0.9999937382200265
408,True,2009_001299,17809,142191,0.0,142191,0,142191,17809,0,17809.0,142191,0.0,0.0,1.0,0.9999929672555418
409,True,2009_001433,13520,146480,0.0,146480,0,146480,13520,0,13520.0,146480,0.0,0.0,1.0,0.9999931731760433
410,True,2009_001433,20545,139455,0.0,139455,0,139455,20545,0,20545.0,139455,0.0,0.0,1.0,0.999992829279486
411,False,2009_001535,57727,98979,58158.0,98979,57662,98483,65,496,58223.0,99475,0.9903646325335349,0.9914544610464416,0.9900276451369691,0.994978783592645
412,False,2009_001663,9668,80226,6207.0,80226,6146,80165,3522,61,9729.0,80287,0.6317196011923116,0.9900128865979382,0.9984804513806719,0.9992271928403156
413,False,2009_001687,37211,115841,32975.0,115841,32691,115557,4520,284,37495.0,116125,0.8718762501666889,0.9913573508005823,0.9951087190527449,0.9975397524214016
414,False,2009_001687,38496,114556,21827.0,114556,5227,97956,33269,16600,55096.0,131156,0.09487077101785973,0.239463074949606,0.7468663271219006,0.8550852414082073
415,True,2009_001718,5067,154933,0.0,154933,0,154933,5067,0,5067.0,154933,0.0,0.0,1.0,0.9999935456387882
416,True,2009_001768,57733,102267,0.0,102267,0,102267,57733,0,57733.0,102267,0.0,0.0,1.0,0.9999902217702508
417,True,2009_001854,70437,89563,0.0,89563,0,89563,70437,0,70437.0,89563,0.0,0.0,1.0,0.9999888347996964
418,False,2009_002012,40188,113604,33717.0,113604,33628,113515,6560,89,40277.0,113693,0.8349181915236984,0.9973308025387033,0.9984343803048561,0.999207781347652
419,True,2009_002042,3710,156290,0.0,156290,0,156290,3710,0,3710.0,156290,0.0,0.0,1.0,0.9999936016789195
420,True,2009_002097,20485,139515,0.0,139515,0,139515,20485,0,20485.0,139515,0.0,0.0,1.0,0.9999928323633132
421,True,2009_002155,39438,120562,0.0,120562,0,120562,39438,0,39438.0,120562,0.0,0.0,1.0,0.9999917055813143
422,True,2009_002165,38241,121759,0.0,121759,0,121759,38241,0,38241.0,121759,0.0,0.0,1.0,0.9999917871222076
423,False,2009_002185,73214,72627,102048.0,72627,71479,42058,1735,30569,103783.0,103196,0.6887351493019088,0.7004380248704054,0.4075545563781542,0.5790879550586551
424,False,2009_002239,45604,97630,47356.0,97630,44957,95231,647,2399,48003.0,100029,0.9365456325646314,0.9493211140908419,0.9520339101660519,0.975417643986029
425,False,2009_002239,9607,133627,3467.0,133627,2886,133046,6721,581,10188.0,134208,0.2832744405182568,0.8321799307958477,0.9913417978063901,0.9956446253779148
426,True,2009_002317,42138,117862,0.0,117862,0,117862,42138,0,42138.0,117862,0.0,0.0,1.0,0.9999915155731655
427,False,2009_002317,36199,118234,13448.0,118234,12676,117462,23523,772,36971.0,119006,0.34286332530902597,0.942523607703175,0.987025864242139,0.9934621727914746
428,False,2009_002346,2472,149609,2418.0,149609,2251,149442,221,167,2639.0,149776,0.8529746115953013,0.930549813972716,0.9977700032047858,0.9988770804090635
429,True,2009_002346,22087,137913,0.0,137913,0,137913,22087,0,22087.0,137913,0.0,0.0,1.0,0.9999927491045144
430,True,2009_002372,10,159990,0.0,159990,0,159990,10,0,10.0,159990,0.0,0.0,1.0,0.9999937496484177
431,False,2009_002382,33322,114521,39994.0,114521,32524,107051,798,7470,40792.0,121991,0.7973131986664052,0.8132016502062758,0.8775319490782106,0.9347636262028256
432,True,2009_002382,22485,137515,0.0,137515,0,137515,22485,0,22485.0,137515,0.0,0.0,1.0,0.9999927281189098
433,True,2009_002415,103100,56900,0.0,56900,0,56900,103100,0,103100.0,56900,0.0,0.0,1.0,0.9999824256164215
434,True,2009_002445,12754,147246,0.0,147246,0,147246,12754,0,12754.0,147246,0.0,0.0,1.0,0.9999932086901601
435,False,2009_002487,13296,124770,9652.0,124770,8047,123165,5249,1605,14901.0,126375,0.5400308704113818,0.8336268517559308,0.9745994065281899,0.9871284192640918
436,True,2009_002539,22694,137306,0.0,137306,0,137306,22694,0,22694.0,137306,0.0,0.0,1.0,0.9999927170501139
437,False,2009_002571,34827,101246,4021.0,101246,2409,99634,32418,1612,36439.0,102858,0.06611048601772826,0.5989557434112381,0.9686558167570826,0.9840686637628769
438,True,2009_002584,25,159975,0.0,159975,0,159975,25,0,25.0,159975,0.0,0.0,1.0,0.9999937490623594
439,False,2009_002649,31739,64050,17565.0,64050,21,46506,31718,17544,49283.0,81594,0.00042611042347259705,0.00119549128999203,0.5699683800279433,0.726077656867184
440,True,2009_002651,18782,141218,0.0,141218,0,141218,18782,0,18782.0,141218,0.0,0.0,1.0,0.9999929187998782
441,True,2009_002651,17969,142031,0.0,142031,0,142031,17969,0,17969.0,142031,0.0,0.0,1.0,0.9999929593331081
442,False,2009_002732,68735,79763,58611.0,79763,54042,75194,14693,4569,73304.0,84332,0.7372312561388191,0.9220296185081553,0.8916425556135275,0.942705982648814
443,False,2009_002975,38421,114426,36899.0,114426,36519,114046,1902,380,38801.0,114806,0.9411870828071441,0.9896747967479674,0.9933801369266415,0.9966703662597114
444,False,2009_003003,54389,92509,39080.0,92509,24096,77525,30293,14984,69373.0,107493,0.3473397431277298,0.6165655945344285,0.7212097531932312,0.8380175116203654
445,True,2009_003003,79873,80127,0.0,80127,0,80127,79873,0,79873.0,80127,0.0,0.0,1.0,0.9999875199680511
446,False,2009_003063,11603,144693,11800.0,144693,11264,144157,339,536,12139.0,145229,0.9279182799242112,0.9544953817473095,0.9926185541455219,0.9962887196428325
447,True,2009_003065,8025,151975,0.0,151975,0,151975,8025,0,8025.0,151975,0.0,0.0,1.0,0.9999934200136864
448,True,2009_003071,25488,134512,10303.0,134512,10050,134259,15438,253,25741.0,134765,0.39042772231071055,0.9753493788819876,0.9962453159203057,0.9981117066751912
449,True,2009_003071,15535,144465,51392.0,144465,13537,106610,1998,37855,53390.0,182320,0.25354935381157523,0.2634016305722569,0.584741114523914,0.7379591045643957
450,False,2009_003123,8311,145813,9926.0,145813,0,135887,8311,9926,18237.0,155739,0.0,0.0,0.8725303231688916,0.9319201174098509
451,False,2009_003196,15024,141393,15257.0,141393,14694,140830,330,563,15587.0,141956,0.9427086674793097,0.9630357845064884,0.992067964721463,0.99601114615896
452,True,2009_003217,33003,126997,0.0,126997,0,126997,33003,0,33003.0,126997,0.0,0.0,1.0,0.9999921258602498
453,True,2009_003241,45794,114206,0.0,114206,0,114206,45794,0,45794.0,114206,0.0,0.0,1.0,0.9999912439692838
454,False,2009_003269,40057,114667,48748.0,114667,37289,103208,2768,11459,51516.0,126126,0.7238333721562233,0.7649182547334304,0.8182928182928183,0.9000593016360275
455,False,2009_003323,15969,138734,16262.0,138734,15753,138225,216,509,16478.0,139243,0.9560019419832504,0.9686404722375945,0.992689040023556,0.9963239269110175
456,True,2009_003323,18366,141634,0.0,141634,0,141634,18366,0,18366.0,141634,0.0,0.0,1.0,0.9999929395982632
457,False,2009_003466,54664,100242,41287.0,100242,35723,94678,18941,5564,60228.0,105806,0.5931294414558013,0.8652150745979461,0.8948263803565015,0.944484901688896
458,True,2009_003481,9539,150461,0.0,150461,0,150461,9539,0,9539.0,150461,0.0,0.0,1.0,0.9999933538036182
459,True,2009_003494,27756,132244,0.0,132244,0,132244,27756,0,27756.0,132244,0.0,0.0,1.0,0.9999924382774396
460,False,2009_003507,14140,134530,10592.0,134530,8578,132516,5562,2014,16154.0,136544,0.5310139903429492,0.8097800434249033,0.9705003515350363,0.9850220395299225
461,True,2009_003576,4661,155339,0.0,155339,0,155339,4661,0,4661.0,155339,0.0,0.0,1.0,0.9999935625080468
462,False,2009_003576,17910,136470,13509.0,136470,11351,134312,6559,2158,20068.0,138628,0.5656268686466015,0.8401924500370096,0.9688663184926566,0.9841797891127053
463,False,2009_003756,81839,68570,65174.0,68570,63015,66411,18824,2159,83998.0,70729,0.7501964332484107,0.9668584579976985,0.9389500770546735,0.9684998031237695
464,False,2009_003804,29938,123410,29549.0,123410,29364,123225,574,185,30123.0,123595,0.9748033064435813,0.9937055837563452,0.9970063513896193,0.9984928409947249
465,False,2009_003810,56038,96622,51227.0,96622,50423,95818,5615,804,56842.0,97426,0.8870729390239611,0.9842859373779964,0.9834951655615544,0.9916686503213521
466,True,2009_003849,3033,156967,0.0,156967,0,156967,3033,0,3033.0,156967,0.0,0.0,1.0,0.9999936292747567
467,True,2009_003849,27161,132839,0.0,132839,0,132839,27161,0,27161.0,132839,0.0,0.0,1.0,0.9999924721469436
468,False,2009_003903,18570,132132,19532.0,132132,16153,128753,2417,3379,21949.0,135511,0.7359332999225477,0.8269595044284033,0.9501295097814938,0.9744197134705184
469,True,2009_003928,9516,150484,0.0,150484,0,150484,9516,0,9516.0,150484,0.0,0.0,1.0,0.9999933548194172
470,True,2009_003991,18735,141265,13526.0,141265,6571,134310,12164,6955,25690.0,148220,0.25578045932269367,0.48576920233606863,0.9061530157873431,0.9507595599790466
471,True,2009_003991,17439,142561,13276.0,142561,11075,140360,6364,2201,19640.0,144762,0.5639002036659878,0.834149280711004,0.9695914673740347,0.9845540887473521
472,False,2009_004033,3262,155554,3236.0,155554,3106,155424,156,130,3392.0,155684,0.9156839622641509,0.9595304294099475,0.9983299504123738,0.9991578541351933
473,False,2009_004043,46793,104952,33743.0,104952,33730,104939,13063,13,46806.0,104965,0.7206341067384523,0.9995851114272167,0.999752298385176,0.9998666069573999
474,True,2009_004043,53372,106628,33743.0,106628,33705,106590,19667,38,53410.0,106666,0.6310615989515073,0.998844238975818,0.9992874955468471,0.9996342458430634
475,True,2009_004140,136,159864,0.0,159864,0,159864,136,0,136.0,159864,0.0,0.0,1.0,0.9999937447221093
476,True,2009_004221,17075,142925,0.0,142925,0,142925,17075,0,17075.0,142925,0.0,0.0,1.0,0.9999930033723745
477,False,2009_004455,36990,115407,34809.0,115407,33798,114396,3192,1011,38001.0,116418,0.8893976474303308,0.970927894283252,0.9826315518218832,0.9912311104949397
478,True,2009_004497,75468,84532,0.0,84532,0,84532,75468,0,75468.0,84532,0.0,0.0,1.0,0.999988170300356
479,False,2009_004507,44378,107632,44160.0,107632,43931,107403,447,229,44607.0,107861,0.9848454278476473,0.9947917846063269,0.9957537942351731,0.9978631088978287
480,True,2009_004507,10645,149355,0.0,149355,0,149355,10645,0,10645.0,149355,0.0,0.0,1.0,0.9999933045876965
481,False,2009_004581,8645,148825,8015.0,148825,7854,148664,791,161,8806.0,148986,0.8918918918918919,0.9797904191616766,0.9978387231014995,0.9989114805208767
482,True,2009_004592,13258,146742,0.0,146742,0,146742,13258,0,13258.0,146742,0.0,0.0,1.0,0.9999931853648897
483,True,2009_004738,32413,127587,7400.0,127587,7400,127587,25013,0,32413.0,127587,0.22830345848887793,0.9998648831239022,1.0,0.999992162272314
484,False,2009_004738,29146,125076,7400.0,125076,7400,125076,21746,0,29146.0,125076,0.25389418788169904,0.9998648831239022,1.0,0.9999920049249662
485,True,2009_004848,16125,143875,0.0,143875,0,143875,16125,0,16125.0,143875,0.0,0.0,1.0,0.9999930495704634
486,True,2009_004859,28079,131921,0.0,131921,0,131921,28079,0,28079.0,131921,0.0,0.0,1.0,0.9999924197631934
487,True,2009_004859,10639,149361,0.0,149361,0,149361,10639,0,10639.0,149361,0.0,0.0,1.0,0.9999933048566569
488,False,2009_004942,40776,111534,40415.0,111534,39663,110782,1113,752,41528.0,112286,0.955090541321518,0.9813687648456056,0.9866056320467378,0.9932487559958757
489,False,2009_004987,24134,127030,13660.0,127030,13645,127015,10489,15,24149.0,127045,0.5650337488094745,0.9988287826659834,0.9997638631980794,0.9998740464925884
490,False,2009_004987,22477,128687,7379.0,128687,5132,126440,17345,2247,24724.0,130934,0.20757159035754733,0.6953929539295393,0.9656773641682069,0.9825313937585478
491,True,2009_004994,42489,117511,27049.0,117511,24566,115028,17923,2483,44972.0,119994,0.5462510006226097,0.9081700554528651,0.9586145973965365,0.9788617332697938
492,False,2009_004994,22082,132758,27049.0,132758,19548,125257,2534,7501,29583.0,140259,0.6607849102525098,0.7226617375231054,0.8930407317890474,0.9434915900240285
493,True,2009_005038,42209,117791,47133.0,117791,23712,94370,18497,23421,65630.0,141212,0.36129818680481485,0.5030763355539526,0.6682859813613574,0.8011579733767998
494,False,2009_005038,45492,102666,47133.0,102666,31386,86919,14106,15747,61239.0,118413,0.5125165335815411,0.6658887427334833,0.7340325808821666,0.8466108876269882
495,False,2009_005078,19470,134220,16221.0,134220,16057,134056,3413,164,19634.0,134384,0.8178160334114292,0.9898286277894218,0.9975592332420526,0.9987706841701373
496,True,2009_005087,16795,143205,0.0,143205,0,143205,16795,0,16795.0,143205,0.0,0.0,1.0,0.9999930170523581
497,True,2009_005217,78092,81908,0.0,81908,0,81908,78092,0,78092.0,81908,0.0,0.0,1.0,0.9999877913294022
498,True,2009_005217,9693,150307,0.0,150307,0,150307,9693,0,9693.0,150307,0.0,0.0,1.0,0.999993346994172
499,False,2010_000003,7049,142073,9570.0,142073,6532,139035,517,3038,10087.0,145111,0.6475661742837315,0.6824783199247727,0.9581286049989318,0.9786097385869336
500,False,2010_000038,22754,129520,28212.0,129520,22327,123635,427,5885,28639.0,135405,0.7796012430601628,0.7913727714174317,0.9130755880506628,0.9545556319052508
501,True,2010_000038,21126,138874,0.0,138874,0,138874,21126,0,21126.0,138874,0.0,0.0,1.0,0.999992799279928
502,True,2010_000087,965,159035,6646.0,159035,0,152389,965,6646,7611.0,165681,0.0,0.0,0.919773540719817,0.9582044317009986
503,False,2010_000087,3936,143293,6646.0,143293,0,136647,3936,6646,10582.0,149939,0.0,0.0,0.9113506159171396,0.9536128518988932
504,True,2010_000110,11457,148543,34844.0,148543,11129,124828,328,23715,35172.0,172258,0.31641646764471737,0.31938585162864114,0.7246572002461424,0.8403436018957346
505,True,2010_000110,142443,17557,0.0,17557,0,17557,142443,0,142443.0,17557,0.0,0.0,1.0,0.9999430459050006
506,True,2010_000159,137701,22299,0.0,22299,0,22299,137701,0,137701.0,22299,0.0,0.0,1.0,0.9999551569506726
507,True,2010_000174,38081,121919,44475.0,121919,33789,111233,4292,10686,48767.0,132605,0.6928660774704206,0.7597131036963756,0.8388296067267449,0.9123441601049869
508,False,2010_000174,44429,107156,44475.0,107156,41553,104234,2876,2922,47351.0,110078,0.8775527443982176,0.9342791617951255,0.9469103726448518,0.9727222673273794
509,True,2010_000216,72946,87054,0.0,87054,0,87054,72946,0,72946.0,87054,0.0,0.0,1.0,0.9999885130090173
510,True,2010_000238,26565,133435,0.0,133435,0,133435,26565,0,26565.0,133435,0.0,0.0,1.0,0.9999925057705567
511,False,2010_000256,31930,116295,10136.0,116295,9120,115279,22810,1016,32946.0,117311,0.2768166089965398,0.8996744598993786,0.9826785211957958,0.9912550732613331
512,True,2010_000422,18002,141998,0.0,141998,0,141998,18002,0,18002.0,141998,0.0,0.0,1.0,0.9999929576968852
513,False,2010_000530,16730,139399,16112.0,139399,15467,138754,1263,645,17375.0,140044,0.8901870503597122,0.9599081486998076,0.9907886092942219,0.9953658536585366
514,True,2010_000559,16371,143629,0.0,143629,0,143629,16371,0,16371.0,143629,0.0,0.0,1.0,0.9999930376662257
515,False,2010_000639,8501,144202,9280.0,144202,8009,142931,492,1271,9772.0,145473,0.8195865738845681,0.8629458032539598,0.9825259670179346,0.991179101683044
516,True,2010_000666,18907,141093,3898.0,141093,2847,140042,16060,1051,19958.0,142144,0.1426495640845776,0.7301872274942293,0.9852121791985592,0.9925439777736828
517,False,2010_000666,5932,143962,3898.0,143962,3528,143592,2404,370,6302.0,144332,0.5598222786417011,0.9048473967684022,0.9948729318515644,0.9974229489521613
518,True,2010_000738,4746,155254,0.0,155254,0,155254,4746,0,4746.0,155254,0.0,0.0,1.0,0.9999935589836076
519,False,2010_000788,30721,124282,29946.0,124282,29573,123909,1148,373,31094.0,124655,0.9510838103814241,0.9875112699101747,0.9940154827323413,0.9969907388782054
520,True,2010_000874,68237,91763,0.0,91763,0,91763,68237,0,68237.0,91763,0.0,0.0,1.0,0.9999891024802755
521,False,2010_000904,132612,20387,101386.0,20387,98403,17404,34209,2983,135595.0,23370,0.7257126000221247,0.9705682188051723,0.7447154471544716,0.8536393957229743
522,False,2010_001024,2830,142641,5938.0,142641,2752,139455,78,3186,6016.0,145827,0.4574468085106383,0.4633776730089241,0.9563043880762822,0.9776573519720699
523,True,2010_001124,78932,81068,0.0,81068,0,81068,78932,0,78932.0,81068,0.0,0.0,1.0,0.9999876648287261
524,False,2010_001251,71692,79936,71963.0,79936,68679,76652,3013,3284,74976.0,83220,0.9160131241997439,0.954352176088044,0.9210766642633982,0.9589051377960144
525,False,2010_001264,81720,72821,82747.0,72821,80350,70424,1370,2397,84117.0,75218,0.9552171380339289,0.9710204476241118,0.9362652556568907,0.9670703908159622
526,False,2010_001313,7160,148785,4871.0,148785,4316,148230,2844,555,7715.0,149340,0.5594296824368115,0.8858784893267652,0.9925672961028525,0.9962630892691516
527,False,2010_001313,6969,148976,2799.0,148976,2536,148713,4433,263,7232.0,149239,0.3506637168141593,0.9057142857142857,0.996475452127125,0.9982279143760446
528,True,2010_001367,26519,133481,0.0,133481,0,133481,26519,0,26519.0,133481,0.0,0.0,1.0,0.9999925083531862
529,False,2010_001376,91347,51505,92652.0,51505,91072,49925,275,1580,92927.0,53085,0.9800380944181992,0.9829363323367835,0.9404728265988509,0.9693045470430629
530,False,2010_001451,85233,69212,84981.0,69212,84403,68634,830,578,85811.0,69790,0.983591847199077,0.9931867924972347,0.9834360223527726,0.9916345195266785
531,True,2010_001553,145750,14250,0.0,14250,0,14250,145750,0,145750.0,14250,0.0,0.0,1.0,0.9999298294856501
532,True,2010_001563,8923,151077,0.0,151077,0,151077,8923,0,8923.0,151077,0.0,0.0,1.0,0.9999933809025802
533,True,2010_001563,2747,157253,1746.0,157253,1672,157179,1075,74,2821.0,157327,0.5926976249556895,0.9570692615912993,0.9990592841660999,0.999523064596131
534,False,2010_001579,38555,110647,52274.0,110647,20518,78891,18037,31756,70311.0,142403,0.29181778100155026,0.3925011956001913,0.5539981601511205,0.7129907454269395
535,False,2010_001579,43471,105731,59648.0,105731,34925,81008,8546,24723,68194.0,130454,0.5121418306595888,0.5855085583999732,0.6209698437763503,0.7661635077365414
536,False,2010_001692,37719,113551,25890.0,113551,23083,110744,14636,2807,40526.0,116358,0.5695849578048661,0.8915453246301803,0.9517523505044776,0.9752712413695928
537,False,2010_001699,20991,126639,20290.0,126639,18514,124863,2477,1776,22767.0,128415,0.8131945359511574,0.9124242274900202,0.9723396799439318,0.9859680985470626
538,False,2010_001734,1939,152114,2921.0,152114,1939,151132,0,982,2921.0,153096,0.6638137624101336,0.663586584531143,0.9871714479803522,0.9935377839134865
539,True,2010_001767,14822,145178,0.0,145178,0,145178,14822,0,14822.0,145178,0.0,0.0,1.0,0.999993111951453
540,True,2010_001851,4391,155609,0.0,155609,0,155609,4391,0,4391.0,155609,0.0,0.0,1.0,0.9999935736777842
541,True,2010_001908,5419,154581,0.0,154581,0,154581,5419,0,5419.0,154581,0.0,0.0,1.0,0.9999935309415068
542,False,2010_001956,87338,67765,72613.0,67765,67051,62203,20287,5562,92900.0,73327,0.7217545748116254,0.9233894290357232,0.8482959891990672,0.9179086857716259
543,True,2010_002017,20592,139408,0.0,139408,0,139408,20592,0,20592.0,139408,0.0,0.0,1.0,0.9999928268619673
544,False,2010_002137,8789,117957,11571.0,117957,8360,114746,429,3211,12000.0,121168,0.6966666666666667,0.7224334600760456,0.9469992077116071,0.972769968972007
545,True,2010_002161,24272,135728,0.0,135728,0,135728,24272,0,24272.0,135728,0.0,0.0,1.0,0.9999926323777527
546,True,2010_002161,19032,140968,0.0,140968,0,140968,19032,0,19032.0,140968,0.0,0.0,1.0,0.9999929062417978
547,True,2010_002228,63832,96168,0.0,96168,0,96168,63832,0,63832.0,96168,0.0,0.0,1.0,0.9999896016387817
548,False,2010_002251,41144,108622,29046.0,108622,28589,108165,12555,457,41601.0,109079,0.6872190572342011,0.98423245085551,0.9916207519320859,0.9957835817460391
549,False,2010_002251,31440,118326,12441.0,118326,12018,117903,19422,423,31863.0,118749,0.3771772902739855,0.965921877511654,0.9928757294798272,0.9964167096267124
550,False,2010_002271,68278,83162,68653.0,83162,67170,81679,1108,1483,69761.0,84645,0.9628589039721335,0.9783843621638943,0.9649595368893614,0.9821555258949293
551,True,2010_002336,43599,116401,0.0,116401,0,116401,43599,0,43599.0,116401,0.0,0.0,1.0,0.9999914090823182
552,False,2010_002396,32092,120708,15012.0,120708,14913,120609,17179,99,32191.0,120807,0.46326613028486224,0.9933391061080397,0.9983610221262013,0.999171561358308
553,True,2010_002396,36406,123594,15012.0,123594,14925,123507,21481,87,36493.0,123681,0.40898254459759403,0.9941384133750749,0.9985931549712567,0.9992879970872608
554,False,2010_002480,100950,55513,101998.0,55513,100790,54305,160,1208,102158.0,56721,0.9866089782493784,0.9881469426170845,0.9574055464466423,0.9782217098389595
555,True,2010_002623,51981,108019,0.0,108019,0,108019,51981,0,51981.0,108019,0.0,0.0,1.0,0.9999907424551009
556,True,2010_002691,52693,107307,0.0,107307,0,107307,52693,0,52693.0,107307,0.0,0.0,1.0,0.9999906810303053
557,True,2010_002763,10653,149347,0.0,149347,0,149347,10653,0,10653.0,149347,0.0,0.0,1.0,0.999993304229049
558,True,2010_002792,51602,108398,0.0,108398,0,108398,51602,0,51602.0,108398,0.0,0.0,1.0,0.999990774822646
559,True,2010_002902,64173,95827,0.0,95827,0,95827,64173,0,64173.0,95827,0.0,0.0,1.0,0.9999895646366407
560,True,2010_002929,74331,85669,0.0,85669,0,85669,74331,0,74331.0,85669,0.0,0.0,1.0,0.9999883273024396
561,False,2010_003014,2260,134788,63535.0,134788,1526,72779,734,62009,64269.0,196797,0.023743951205091103,0.02401787962729791,0.3698176293337805,0.5399476218385774
562,False,2010_003060,53192,102535,44176.0,102535,43098,101457,10094,1078,54270.0,103613,0.7941404090657822,0.9755755257260565,0.9791918002567246,0.9894768666614653
563,False,2010_003187,63880,92057,66670.0,92057,63130,88517,750,3540,67420.0,95597,0.9363690299614358,0.9468884522506037,0.9259390985072753,0.9615351191640052
564,False,2010_003207,20349,134425,20968.0,134425,19307,132764,1042,1661,22010.0,136086,0.8771921853702862,0.9207401402069721,0.9755889658010376,0.9876363203546933
565,False,2010_003239,5674,141605,9245.0,141605,5656,138016,18,3589,9263.0,145194,0.6106013170679045,0.6117239887518927,0.9505626954281857,0.9746479668940582
566,False,2010_003325,55312,85807,17255.0,85807,11449,80001,43863,5806,61118.0,91613,0.18732615596060082,0.6634793694946686,0.8732494296660954,0.9323256572813724
567,False,2010_003325,52236,88883,37603.0,88883,37375,88655,14861,228,52464.0,89111,0.7123932601402867,0.9939102223167748,0.9948827866368911,0.9974236082984564
568,False,2010_003381,5078,146228,21720.0,146228,475,124983,4603,21245,26323.0,167473,0.0180450556547506,0.021868238110584227,0.7462874612624124,0.8547073425927826
569,True,2010_003409,991,159009,0.0,159009,0,159009,991,0,991.0,159009,0.0,0.0,1.0,0.999993711087353
570,False,2010_003446,4884,145964,2927.0,145964,2916,145953,1968,11,4895.0,145975,0.5957099080694587,0.9959016393442623,0.9998492892618599,0.9999177885109444
571,False,2010_003506,37770,118394,44278.0,118394,37502,111618,268,6776,44546.0,125170,0.8418713240246037,0.846947763047946,0.8917312455061117,0.9427594070695553
572,True,2010_003531,2880,157120,0.0,157120,0,157120,2880,0,2880.0,157120,0.0,0.0,1.0,0.9999936354783893
573,False,2010_003532,58896,89478,54791.0,89478,53419,88106,5477,1372,60268.0,90850,0.8863576027079046,0.9749415973134764,0.9697963676389654,0.9846556175191944
574,True,2010_003597,3619,156381,0.0,156381,0,156381,3619,0,3619.0,156381,0.0,0.0,1.0,0.9999936054021562
575,True,2010_003597,404,159596,0.0,159596,0,159596,404,0,404.0,159596,0.0,0.0,1.0,0.9999937342180617
576,False,2010_003746,76645,71559,73601.0,71559,72988,70946,3657,613,77258.0,72172,0.9447306427813301,0.991657835384908,0.9830128027489885,0.9914197875908328
577,False,2010_003746,66741,81463,20011.0,81463,2685,64137,64056,17326,84067.0,98789,0.031938810710504716,0.1341694983010194,0.6492322019658059,0.7873048217617598
578,False,2010_003947,32575,108949,25191.0,108949,24996,108754,7579,195,32770.0,109144,0.7627708269758926,0.9922197523023182,0.9964267389870263,0.9982010096374484
579,False,2010_003971,3137,138589,27939.0,138589,1612,112262,1525,26327,29464.0,164916,0.05471083355959815,0.05769506084466714,0.6807223071139247,0.810029583664045
580,False,2010_004042,17564,135453,16573.0,135453,16269,135149,1295,304,17868.0,135757,0.9105104096709201,0.9815976831181369,0.9955214095774066,0.9977483130804553
581,True,2010_004165,26244,133756,0.0,133756,0,133756,26244,0,26244.0,133756,0.0,0.0,1.0,0.9999925237557661
582,True,2010_004165,31500,128500,0.0,128500,0,128500,31500,0,31500.0,128500,0.0,0.0,1.0,0.9999922179593933
583,True,2010_004219,9877,150123,7106.0,150123,0,143017,9877,7106,16983.0,157229,0.0,0.0,0.9096095504010074,0.9526591351149716
584,False,2010_004219,12869,112636,7106.0,112636,0,105530,12869,7106,19975.0,119742,0.0,0.0,0.8813114863623457,0.9369035041771354
585,False,2010_004337,2028,155660,1347.0,155660,1173,155486,855,174,2202.0,155834,0.5326975476839237,0.8701780415430267,0.9977668544733499,0.9988757620727093
586,False,2010_004355,46056,107555,46691.0,107555,45602,106466,454,1089,47145.0,108644,0.9672711846431222,0.9766555298552214,0.9799528736055374,0.9898657443564283
587,False,2010_004432,14333,10445,24778.0,10445,14333,0,0,10445,24778.0,20890,0.5784566954556462,0.5784333508212599,0.0,0.0
588,False,2010_004472,19305,132696,45949.0,132696,11504,98251,7801,34445,53750.0,167141,0.21402790697674418,0.25035908596300327,0.5878330272045758,0.7404161360091035
589,True,2010_004479,53673,106327,0.0,106327,0,106327,53673,0,53673.0,106327,0.0,0.0,1.0,0.9999905951395681
590,False,2010_004519,47822,106417,47692.0,106417,47524,106249,298,168,47990.0,106585,0.9902896436757658,0.9964565030507622,0.996847586433363,0.9984119227950159
591,True,2010_004550,40128,119872,0.0,119872,0,119872,40128,0,40128.0,119872,0.0,0.0,1.0,0.9999916578378785
592,False,2010_004559,16932,134212,5529.0,134212,3579,132262,13353,1950,18882.0,136162,0.18954559898315856,0.6471971066907776,0.9713576475081154,0.9854634051842966
593,True,2010_004628,6508,153492,0.0,153492,0,153492,6508,0,6508.0,153492,0.0,0.0,1.0,0.9999934850449206
594,False,2010_004697,28591,110068,12749.0,110068,8501,105820,20090,4248,32839.0,114316,0.25886902768050185,0.6667450980392157,0.9256796948808566,0.9613969419182513
595,True,2010_004697,17505,142495,0.0,142495,0,142495,17505,0,17505.0,142495,0.0,0.0,1.0,0.9999929822591511
596,False,2010_004795,5093,152702,5496.0,152702,5080,152286,13,416,5509.0,153118,0.922127427845344,0.924140440240131,0.9945662822137176,0.9972692088564076
597,True,2010_004815,25655,134345,0.0,134345,0,134345,25655,0,25655.0,134345,0.0,0.0,1.0,0.9999925565331309
598,False,2010_004825,4358,139435,6280.0,139435,3126,136281,1232,3154,7512.0,142589,0.41613418530351437,0.49769145040598634,0.955760963328167,0.9773731317593735
599,False,2010_004828,6019,69143,9671.0,69143,6019,65491,0,3652,9671.0,72795,0.6223761761968772,0.6223118279569892,0.8996634384229686,0.9471682286243203
600,True,2010_004856,60702,99298,0.0,99298,0,99298,60702,0,60702.0,99298,0.0,0.0,1.0,0.99998992940513
601,True,2010_004941,45576,114424,0.0,114424,0,114424,45576,0,45576.0,114424,0.0,0.0,1.0,0.9999912606510815
602,False,2010_004951,35579,122348,991.0,122348,991,122348,34588,0,35579.0,122348,0.02785350909244217,0.998991935483871,1.0,0.999991826659801
603,True,2010_005046,65814,94186,74504.0,94186,58208,77890,7606,16296,82110.0,110482,0.7089026915113872,0.7812630024830548,0.7050017197371518,0.8269718750995361
604,True,2010_005046,8955,151045,0.0,151045,0,151045,8955,0,8955.0,151045,0.0,0.0,1.0,0.9999933795002847
605,False,2010_005118,24191,129216,5323.0,129216,4790,128683,19401,533,24724.0,129749,0.19373887720433586,0.8996994740796393,0.9917841370646402,0.9958674168259595
606,False,2010_005159,104448,50961,101268.0,50961,100725,50418,3723,543,104991.0,51504,0.9593679458239278,0.994628168541212,0.9789142590866728,0.9893253796946745
607,False,2010_005160,28334,119376,27898.0,119376,26529,118007,1805,1369,29703.0,120745,0.8931421068578932,0.9508942972866411,0.9773241127997019,0.9885237524816338
608,True,2010_005166,10636,149364,0.0,149364,0,149364,10636,0,10636.0,149364,0.0,0.0,1.0,0.9999933049911292
609,True,2010_005174,58876,101124,0.0,101124,0,101124,58876,0,58876.0,101124,0.0,0.0,1.0,0.9999901112484548
610,True,2010_005206,65786,94214,0.0,94214,0,94214,65786,0,65786.0,94214,0.0,0.0,1.0,0.9999893859788781
611,False,2010_005245,2248,155494,1876.0,155494,1791,155409,457,85,2333.0,155579,0.7676810972996142,0.9541822056473095,0.9989073075415063,0.9994469275539406
612,True,2010_005245,3708,156292,0.0,156292,0,156292,3708,0,3708.0,156292,0.0,0.0,1.0,0.9999936017607954
613,False,2010_005252,22103,128563,13205.0,128563,11527,126885,10576,1678,23781.0,130241,0.48471468819645935,0.8728608208390126,0.9742323845793567,0.9869403565539342
614,False,2010_005252,2253,148413,5991.0,148413,1722,144144,531,4269,6522.0,152682,0.2640294388224471,0.28738317757009346,0.9440798522419146,0.9712291293274219
615,False,2010_005284,3830,148224,5486.0,148224,1265,144003,2565,4221,8051.0,152445,0.15712333871568748,0.2305449243666849,0.944622650792089,0.9715162759318603
616,True,2010_005366,53215,106785,0.0,106785,0,106785,53215,0,53215.0,106785,0.0,0.0,1.0,0.9999906354765606
617,False,2010_005433,32655,121702,34897.0,121702,32308,119113,347,2589,35244.0,124291,0.9166950402905459,0.9257837125336695,0.958339702794249,0.9787186840094328
618,True,2010_005501,65855,94145,0.0,94145,0,94145,65855,0,65855.0,94145,0.0,0.0,1.0,0.9999893781998173
619,True,2010_005575,15982,144018,0.0,144018,0,144018,15982,0,15982.0,144018,0.0,0.0,1.0,0.9999930564717155
620,True,2010_005582,56530,103470,0.0,103470,0,103470,56530,0,56530.0,103470,0.0,0.0,1.0,0.9999903354563114
621,False,2010_005606,27727,123673,31734.0,123673,13934,105873,13793,17800,45527.0,141473,0.30606014013662225,0.43907357806837877,0.7483618782382504,0.8560651389944531
622,False,2010_005626,20495,127671,25392.0,127671,17329,119608,3166,8063,28558.0,135734,0.6068001960921633,0.6824321663450558,0.881194100225441,0.9368381477536186
623,False,2010_005626,37249,110917,47866.0,110917,31204,94255,6045,16662,53911.0,127579,0.5788058095750404,0.6518896107965821,0.7387971374599268,0.8497719035684019
624,True,2010_005644,66018,93982,0.0,93982,0,93982,66018,0,66018.0,93982,0.0,0.0,1.0,0.9999893597778322
625,True,2010_005709,54769,105231,0.0,105231,0,105231,54769,0,54769.0,105231,0.0,0.0,1.0,0.9999904971871674
626,True,2010_005871,6497,153503,0.0,153503,0,153503,6497,0,6497.0,153503,0.0,0.0,1.0,0.9999934855117782
627,True,2010_005991,57502,102498,0.0,102498,0,102498,57502,0,57502.0,102498,0.0,0.0,1.0,0.9999902438072567
628,True,2010_005991,15067,144933,15475.0,144933,13471,142929,1596,2004,17071.0,146937,0.7891160447542616,0.8704445593176532,0.9727230037362952,0.9861661169911822
629,True,2010_005992,17023,142977,0.0,142977,0,142977,17023,0,17023.0,142977,0.0,0.0,1.0,0.9999930059169942
630,True,2011_000045,24225,135775,0.0,135775,0,135775,24225,0,24225.0,135775,0.0,0.0,1.0,0.9999926349281169
631,False,2011_000051,35448,116281,46983.0,116281,13700,82998,21748,33283,68731.0,149564,0.19932781423229692,0.2915886259152052,0.5549330052686475,0.7137648131267093
632,False,2011_000054,11899,112149,62330.0,112149,11410,61229,489,50920,62819.0,163069,0.18163294544644137,0.18305498066772552,0.37547909167285015,0.5459563085153812
633,True,2011_000178,26307,133693,0.0,133693,0,133693,26307,0,26307.0,133693,0.0,0.0,1.0,0.9999925202327704
634,False,2011_000226,24078,125143,21421.0,125143,14231,117953,9847,7190,31268.0,132333,0.4551298452091595,0.6643170572308842,0.8913347388784355,0.9425381959982101
635,True,2011_000248,60175,99825,0.0,99825,0,99825,60175,0,60175.0,99825,0.0,0.0,1.0,0.9999899825696712
636,True,2011_000338,2514,157486,0.0,157486,0,157486,2514,0,2514.0,157486,0.0,0.0,1.0,0.999993650269546
637,True,2011_000396,4762,155238,0.0,155238,0,155238,4762,0,4762.0,155238,0.0,0.0,1.0,0.9999935583197521
638,False,2011_000435,5578,138047,10158.0,138047,4811,132700,767,5347,10925.0,143394,0.44036613272311215,0.4735702332906782,0.9254222631351382,0.9612598516458044
639,False,2011_000438,28411,114424,68742.0,114424,28380,74062,31,40362,68773.0,154786,0.41266194582176147,0.412842034825364,0.4784799658883878,0.6472536596023596
640,True,2011_000455,5263,154737,0.0,154737,0,154737,5263,0,5263.0,154737,0.0,0.0,1.0,0.9999935374633251
641,False,2011_000455,26576,124016,49118.0,124016,22525,97423,4051,26593,53169.0,150609,0.4236491188474487,0.4585801828213115,0.6468604133883101,0.7855616568696228
642,False,2011_000479,10054,138941,89504.0,138941,10054,59491,0,79450,89504.0,218391,0.11233017518770111,0.11232892017205742,0.2724059141631294,0.4281714672309309
643,True,2011_000512,42874,117126,0.0,117126,0,117126,42874,0,42874.0,117126,0.0,0.0,1.0,0.9999914622589156
644,False,2011_000526,102459,48896,95583.0,48896,95223,48536,7236,360,102819.0,49256,0.9261226037989088,0.9962232172748577,0.9853824914731201,0.9926171339754996
645,False,2011_000536,28754,126714,24364.0,126714,23554,125904,5200,810,29564.0,127524,0.7967122175618996,0.9667145495587933,0.9872965088924438,0.9935998105985874
646,True,2011_000566,43202,116798,0.0,116798,0,116798,43202,0,43202.0,116798,0.0,0.0,1.0,0.999991438282862
647,False,2011_000585,22964,127530,11310.0,127530,11166,127386,11798,144,23108.0,127674,0.4832092781720616,0.9871806206347803,0.9977442548991964,0.998863021539861
648,False,2011_000598,29932,127841,47217.0,127841,27236,107860,2696,19981,49913.0,147822,0.5456694648688718,0.5768139268922868,0.729661349460838,0.8436976893352732
649,False,2011_000618,36758,114772,32358.0,114772,29638,112052,7120,2720,39478.0,117492,0.7507472516338214,0.9159121110046664,0.9536989752493786,0.9762923335627718
650,False,2011_000618,9399,142131,10285.0,142131,6434,138280,2965,3851,13250.0,145982,0.4855849056603774,0.6255104024888197,0.9472400706936471,0.972898432443081
651,False,2011_000638,20655,127692,53016.0,127692,20532,95208,123,32484,53139.0,160176,0.3863828826285779,0.38727200709206483,0.5943961642193587,0.745600776863258
652,True,2011_000780,58836,101164,0.0,101164,0,101164,58836,0,58836.0,101164,0.0,0.0,1.0,0.9999901151584046
653,True,2011_000809,6882,153118,0.0,153118,0,153118,6882,0,6882.0,153118,0.0,0.0,1.0,0.9999934691318517
654,False,2011_000809,28292,123419,24957.0,123419,24459,122921,3833,498,28790.0,123917,0.8495658214657867,0.9800064107700938,0.9919623619035322,0.9959568951547562
655,False,2011_000843,61149,89579,81919.0,89579,54257,61917,6892,27662,88811.0,117241,0.6109265744108275,0.66231689453125,0.528117296850078,0.6911922304085734
656,False,2011_000953,47,142223,38774.0,142223,0,103449,47,38774,38821.0,180997,0.0,0.0,0.5715509096835859,0.7273666891663855
657,True,2011_000953,4803,155197,38774.0,155197,4702,121125,101,34072,38875.0,189269,0.12095176848874598,0.12126370083816893,0.6399621702444669,0.7804546450340855
658,True,2011_001014,73360,86640,0.0,86640,0,86640,73360,0,73360.0,86640,0.0,0.0,1.0,0.9999884581202895
659,True,2011_001060,13081,146919,0.0,146919,0,146919,13081,0,13081.0,146919,0.0,0.0,1.0,0.9999931935747346
660,True,2011_001069,47366,112634,0.0,112634,0,112634,47366,0,47366.0,112634,0.0,0.0,1.0,0.9999911217649932
661,False,2011_001071,85800,65536,44829.0,65536,37394,58101,48406,7435,93235.0,72971,0.4010725585885129,0.8341289315190721,0.7962204163297748,0.8865373758334987
662,False,2011_001159,47314,104383,14981.0,104383,14627,104029,32687,354,47668.0,104737,0.3068515565998154,0.9763048992123882,0.9932402111956615,0.9965990956468425
663,True,2011_001276,18022,141978,0.0,141978,0,141978,18022,0,18022.0,141978,0.0,0.0,1.0,0.9999929567048648
664,False,2011_001276,4765,128513,6661.0,128513,3200,125052,1565,3461,8226.0,131974,0.3890104546559689,0.48033623536475534,0.9475502750541773,0.9730613007143191
665,False,2011_001276,21977,111301,72331.0,111301,8055,47025,13922,64276,86253.0,175577,0.09338805606761504,0.11136149975114748,0.26783120796004034,0.42249914646637077
666,True,2011_001346,16792,143208,0.0,143208,0,143208,16792,0,16792.0,143208,0.0,0.0,1.0,0.9999930171986398
667,True,2011_001416,29001,130999,0.0,130999,0,130999,29001,0,29001.0,130999,0.0,0.0,1.0,0.9999923664122138
668,False,2011_001447,13276,120776,58088.0,120776,11378,74066,1898,46710,59986.0,167486,0.1896775914380022,0.19587185181359637,0.44222203646871977,0.6132458994676139
669,False,2011_001530,9793,142763,47067.0,142763,1168,96864,8625,45899,55692.0,188662,0.020972491560726853,0.0248151610435965,0.5134261271480214,0.6784903757249727
670,True,2011_001567,10114,149886,0.0,149886,0,149886,10114,0,10114.0,149886,0.0,0.0,1.0,0.9999933283073249
671,False,2011_001619,7691,139430,39708.0,139430,7666,107388,25,32042,39733.0,171472,0.19293786021694811,0.19305447127855146,0.6262713445927032,0.7701874045226671
672,True,2011_001642,60479,99521,0.0,99521,0,99521,60479,0,60479.0,99521,0.0,0.0,1.0,0.9999899519704186
673,True,2011_001665,0,160000,0.0,160000,0,160000,0,0,0.0,160000,0.0,0.0,1.0,0.9999937500390622
674,False,2011_001674,31968,121583,48814.0,121583,27816,100585,4152,20998,52966.0,142581,0.5251670883208096,0.5698248489193896,0.7054586515734915,0.8272881300171075
675,False,2011_001714,22069,106273,17956.0,106273,16870,105187,5199,1086,23155.0,107359,0.728568343770244,0.939466503313471,0.9797688130478115,0.9897717221521727
676,True,2011_001714,19480,140520,0.0,140520,0,140520,19480,0,19480.0,140520,0.0,0.0,1.0,0.9999928836259349
677,False,2011_001722,29554,120127,29351.0,120127,29278,120054,276,73,29627.0,120200,0.9882202045431532,0.9974788770782229,0.9987853577371049,0.9993839904102291
678,False,2011_001745,42775,60697,39565.0,60697,39247,60379,3528,318,43093.0,61015,0.9107511660826584,0.9919375221149471,0.9895763336884372,0.9947444726350126
679,False,2011_001794,25869,129038,12032.0,129038,4547,121553,21322,7485,33354.0,136523,0.13632547820351382,0.3778775035319538,0.8903481464661632,0.9419865312037446
680,False,2011_001862,4081,149725,1289.0,149725,1071,149507,3010,218,4299.0,149943,0.24912770411723656,0.8302325581395349,0.9970922283801178,0.9985373281861534
681,False,2011_001862,10537,143269,1904.0,143269,1832,143197,8705,72,10609.0,143341,0.1726835705533038,0.9616797900262467,0.9989954025714903,0.9994904725343756
682,False,2011_001868,59740,96706,56155.0,96706,53367,93918,6373,2788,62528.0,99494,0.853489636642784,0.9503347816796068,0.9439564194825819,0.9711603089745313
683,False,2011_001984,40640,113526,39362.0,113526,39142,113306,1498,220,40860.0,113746,0.9579539892315223,0.9943855905291772,0.9961317321048653,0.9980533265214442
684,True,2011_001988,12355,147645,0.0,147645,0,147645,12355,0,12355.0,147645,0.0,0.0,1.0,0.9999932270430625
685,True,2011_002002,10383,149617,0.0,149617,0,149617,10383,0,10383.0,149617,0.0,0.0,1.0,0.9999933163122084
686,False,2011_002040,59435,95279,57566.0,95279,57125,94838,2310,441,59876.0,95720,0.9540550470973345,0.9923219900290097,0.9907856247388216,0.9953610411418976
687,True,2011_002075,1887,158113,0.0,158113,0,158113,1887,0,1887.0,158113,0.0,0.0,1.0,0.9999936754493594
688,True,2011_002075,456,159544,0.0,159544,0,159544,456,0,456.0,159544,0.0,0.0,1.0,0.9999937321758752
689,True,2011_002098,1644,158356,0.0,158356,0,158356,1644,0,1644.0,158356,0.0,0.0,1.0,0.9999936851544295
690,False,2011_002110,34649,102859,34414.0,102859,33994,102439,655,420,35069.0,103279,0.9693461461689812,0.9877669620804882,0.9918666911956933,0.995907058137274
691,False,2011_002110,8497,129011,21306.0,129011,955,108660,7542,20351,28848.0,149362,0.03310454797559623,0.044820950861219316,0.7274942756524417,0.842247232815552
692,False,2011_002121,108267,48014,110663.0,48014,108097,45448,170,2566,110833.0,50580,0.9753142114713127,0.976803657919468,0.8985369711348359,0.9465375403519733
693,False,2011_002124,5560,149817,3678.0,149817,5,146144,5555,3673,9233.0,153490,0.0005415357955160836,0.001359064963305246,0.9521402045735878,0.9754769119865436
694,True,2011_002156,5767,154233,0.0,154233,0,154233,5767,0,5767.0,154233,0.0,0.0,1.0,0.9999935163452935
695,False,2011_002200,11539,135461,54832.0,135461,10966,91595,573,43866,55405.0,179327,0.19792437505640284,0.19998905768424124,0.5107708264790021,0.6761674860846584
696,False,2011_002200,33774,113226,35297.0,113226,23292,101221,10482,12005,45779.0,125231,0.5087922409838572,0.6598674145843957,0.8082743090768261,0.8939652203096434
697,True,2011_002247,6151,153849,0.0,153849,0,153849,6151,0,6151.0,153849,0.0,0.0,1.0,0.9999935001624959
698,False,2011_002279,102064,50253,79253.0,50253,71856,42856,30208,7397,109461.0,57650,0.6564529832543098,0.9066545537133772,0.7433824804856896,0.852787837784057
699,False,2011_002298,30729,113579,25394.0,113579,25122,113307,5607,272,31001.0,113851,0.8103609560981904,0.9892498523331364,0.995221825016908,0.9975964078182779
700,True,2011_002308,45937,114063,0.0,114063,0,114063,45937,0,45937.0,114063,0.0,0.0,1.0,0.9999912329920045
701,True,2011_002317,8225,151775,0.0,151775,0,151775,8225,0,8225.0,151775,0.0,0.0,1.0,0.9999934113430319
702,False,2011_002322,13699,134970,8972.0,134970,8903,134901,4796,69,13768.0,135039,0.6466443927948867,0.992198818678257,0.9989780730011331,0.9994813700720896
703,True,2011_002322,17610,142390,0.0,142390,0,142390,17610,0,17610.0,142390,0.0,0.0,1.0,0.9999929770842259
704,False,2011_002343,76562,73626,71256.0,73626,70504,72874,6058,752,77314.0,74378,0.911917634581059,0.9894326171463856,0.9797789668988142,0.9897727735749113
705,False,2011_002358,20344,124302,24820.0,124302,18701,118183,1643,6119,26463.0,130421,0.7066848051997128,0.753434591676403,0.9061654181458507,0.9507654682509674
706,True,2011_002358,622,159378,0.0,159378,0,159378,622,0,622.0,159378,0.0,0.0,1.0,0.99999372564767
707,False,2011_002371,23334,132166,23381.0,132166,22490,131275,844,891,24225.0,133057,0.9283797729618163,0.9618509964930289,0.986607243512179,0.9932509627970674
708,False,2011_002498,21756,108163,70301.0,108163,19711,57573,2045,50590,72346.0,158753,0.2724545932048766,0.2803760917185855,0.3626577135550194,0.5322750637920195
709,False,2011_002509,2636,147163,4618.0,147163,2000,144545,636,2618,5254.0,149781,0.3806623524933384,0.43299415457891316,0.9650422950841562,0.9822035280367482
710,True,2011_002532,22998,137002,0.0,137002,0,137002,22998,0,22998.0,137002,0.0,0.0,1.0,0.9999927008897616
711,True,2011_002575,35235,124765,0.0,124765,0,124765,35235,0,35235.0,124765,0.0,0.0,1.0,0.9999919849959124
712,True,2011_002578,5934,154066,0.0,154066,0,154066,5934,0,5934.0,154066,0.0,0.0,1.0,0.999993509317375
713,True,2011_002589,103130,56870,0.0,56870,0,56870,103130,0,103130.0,56870,0.0,0.0,1.0,0.999982416345765
714,True,2011_002623,14686,145314,0.0,145314,0,145314,14686,0,14686.0,145314,0.0,0.0,1.0,0.999993118397963
715,True,2011_002641,4722,155278,0.0,155278,0,155278,4722,0,4722.0,155278,0.0,0.0,1.0,0.9999935599791343
716,True,2011_002675,22736,137264,0.0,137264,0,137264,22736,0,22736.0,137264,0.0,0.0,1.0,0.9999927148216953
717,True,2011_002951,105196,54804,0.0,54804,0,54804,105196,0,105196.0,54804,0.0,0.0,1.0,0.9999817534896451
718,False,2011_002997,14865,142031,21227.0,142031,5858,126662,9007,15369,30234.0,157400,0.19375537474366608,0.27595628415300544,0.8047141041931385,0.8917849498704518
719,False,2011_003019,13047,135803,11303.0,135803,9629,134129,3418,1674,14721.0,137477,0.6540995856259765,0.851822363765039,0.9756468354706606,0.9876660481281847
720,False,2011_003019,3657,145193,3745.0,145193,3523,144971,134,222,3879.0,145415,0.9082237690126321,0.9404698344901228,0.9969466698758725,0.9984641238618676
721,True,2011_003085,12107,147893,0.0,147893,0,147893,12107,0,12107.0,147893,0.0,0.0,1.0,0.999993238400476
722,False,2011_003114,1133,148712,6252.0,148712,1123,143583,10,5129,6262.0,153841,0.17933567550303417,0.17959379497841035,0.9333207662456692,0.9655040245304715
723,True,2011_003240,29536,130464,0.0,130464,0,130464,29536,0,29536.0,130464,0.0,0.0,1.0,0.9999923351090331
724,True,2007_000129,124132,35868,0.0,35868,0,35868,124132,0,124132.0,35868,0.0,0.0,1.0,0.9999721207728122
725,False,2007_000323,111557,43534,120931.0,43534,109050,31653,2507,11881,123438.0,55415,0.8834394594857338,0.9017464360136275,0.5711991338085356,0.7270701734236821
726,False,2007_000332,31458,119538,22121.0,119538,21755,119172,9703,366,31824.0,119904,0.6836035696329814,0.9834101799114005,0.9938951160928743,0.9969298722592627
727,False,2007_000346,9030,144918,43910.0,144918,215,101223,8815,43695,52725.0,188613,0.004077761972498814,0.004896267450069458,0.5366703249510903,0.6984798404626033
728,True,2007_000762,1228,158772,0.0,158772,0,158772,1228,0,1228.0,158772,0.0,0.0,1.0,0.9999937016999112
729,True,2007_000762,4,159996,0.0,159996,0,159996,4,0,4.0,159996,0.0,0.0,1.0,0.9999937498828103
730,True,2007_000783,3471,156529,4725.0,156529,3114,154918,357,1611,5082.0,158140,0.6127508854781583,0.6589081675835802,0.9796256481598583,0.9897016546348942
731,False,2007_000783,18370,134941,4725.0,134941,4185,134401,14185,540,18910.0,135481,0.22131147540983606,0.8855268726195514,0.9920284025066245,0.9959908701516207
732,False,2007_000799,49730,104506,40324.0,104506,39045,103227,10685,1279,51009.0,105785,0.7654531553255308,0.9682579045257285,0.9758188779127476,0.9877520166113275
733,True,2007_000799,43664,116336,0.0,116336,0,116336,43664,0,43664.0,116336,0.0,0.0,1.0,0.9999914042823865
734,True,2007_000830,7486,152514,0.0,152514,0,152514,7486,0,7486.0,152514,0.0,0.0,1.0,0.9999934432678753
735,False,2007_000847,7506,148000,30133.0,148000,3116,120983,4390,27017,34523.0,175017,0.09025866813428729,0.1034047919293821,0.6912642771845021,0.8174471794109499
736,True,2007_000847,11993,148007,0.0,148007,0,148007,11993,0,11993.0,148007,0.0,0.0,1.0,0.9999932436084537
737,True,2007_000999,66615,93385,0.0,93385,0,93385,66615,0,66615.0,93385,0.0,0.0,1.0,0.9999892917567944
738,True,2007_001175,4404,155596,0.0,155596,0,155596,4404,0,4404.0,155596,0.0,0.0,1.0,0.9999935731408703
739,False,2007_001239,14853,137486,33978.0,137486,10837,114345,4016,23141,37994.0,160627,0.2852292467231668,0.31893228170340504,0.7118666226724025,0.8316786314342447
740,False,2007_001284,17611,133137,75631.0,133137,17611,75117,0,58020,75631.0,191157,0.23285425288572145,0.23285117410619843,0.3929597137431535,0.5642040589463564
741,True,2007_001311,1237,158763,0.0,158763,0,158763,1237,0,1237.0,158763,0.0,0.0,1.0,0.9999937013428737
742,False,2007_001408,51506,98353,58825.0,98353,44923,84451,6583,13902,65408.0,112255,0.6868120107632094,0.7636589263250944,0.7523139281101064,0.8586432681944811
743,True,2007_001423,6437,153563,0.0,153563,0,153563,6437,0,6437.0,153563,0.0,0.0,1.0,0.9999934880570968
744,False,2007_001430,14150,137845,19052.0,137845,13782,132575,368,5270,19420.0,143115,0.7096807415036045,0.7233506534404031,0.9263529329560144,0.9617616760732992
745,False,2007_001430,1439,150556,34103.0,150556,1439,117892,0,32664,34103.0,183220,0.04219570125795385,0.04219446399249355,0.643445038751228,0.7830389819138267
746,True,2007_001526,20320,139680,0.0,139680,0,139680,20320,0,20320.0,139680,0.0,0.0,1.0,0.9999928408301774
747,True,2007_001585,1331,158669,0.0,158669,0,158669,1331,0,1331.0,158669,0.0,0.0,1.0,0.9999936976113947
748,False,2007_001586,44948,107165,19396.0,107165,18448,106217,26500,948,45896.0,108113,0.4019522398466097,0.9510749084910037,0.9824627935585915,0.9911445794375081
749,True,2007_001586,18557,141443,0.0,141443,0,141443,18557,0,18557.0,141443,0.0,0.0,1.0,0.999992930064195
750,True,2007_001594,9586,150414,0.0,150414,0,150414,9586,0,9586.0,150414,0.0,0.0,1.0,0.999993351726889
751,False,2007_001630,10003,133220,38596.0,133220,9877,104501,126,28719,38722.0,161939,0.2550746345746604,0.25590071767235795,0.6453108886679552,0.7844183724788134
752,False,2007_001677,10913,136132,23863.0,136132,4887,117156,6026,18976,29889.0,155108,0.16350496838301717,0.20478545088836742,0.7553188745906079,0.860599560723704
753,False,2007_001678,8452,144558,12057.0,144558,8450,140951,2,3607,12059.0,148165,0.7007214528567874,0.700779565433737,0.9513110383693855,0.9750413326046804
754,False,2007_001717,11342,138397,28907.0,138397,10934,120424,408,17973,29315.0,156370,0.3729831144465291,0.378234398782344,0.7701221461917248,0.8701281810430787
755,False,2007_001763,75390,76744,51001.0,76744,46403,72146,28987,4598,79988.0,81342,0.5801245186778017,0.9098270656052704,0.8869464729168204,0.9400742719395401
756,False,2007_001955,998,156961,1919.0,156961,998,156040,0,921,1919.0,157882,0.5200625325690463,0.5197916666666667,0.9883330588667486,0.9941259667945108
757,False,2007_002046,64675,88530,61526.0,88530,59976,86980,4699,1550,66225.0,90080,0.9056398640996602,0.9747915549271051,0.9655861456483126,0.9824807129705979
758,True,2007_002119,15057,144943,0.0,144943,0,144943,15057,0,15057.0,144943,0.0,0.0,1.0,0.9999931007837509
759,False,2007_002260,40340,114588,42236.0,114588,40201,112553,139,2035,42375.0,116623,0.9486961651917404,0.95179581883183,0.9651012236008335,0.9822321514281476
760,True,2007_002268,16673,143327,0.0,143327,0,143327,16673,0,16673.0,143327,0.0,0.0,1.0,0.9999930229962045
761,False,2007_002378,14271,115728,20722.0,115728,6815,101821,7456,13907,28178.0,129635,0.24185534814394208,0.3288616513053129,0.7854437459019555,0.8798226892135939
762,True,2007_002426,62170,97830,0.0,97830,0,97830,62170,0,62170.0,97830,0.0,0.0,1.0,0.9999897782911347
763,True,2007_002539,9636,150364,0.0,150364,0,150364,9636,0,9636.0,150364,0.0,0.0,1.0,0.9999933495161774
764,False,2007_002565,3948,144791,3741.0,144791,3494,144544,454,247,4195.0,145038,0.832896305125149,0.9337252805986104,0.9965939960562059,0.9982871981877451
765,False,2007_002597,48312,103950,27860.0,103950,25153,101243,23159,2707,51019.0,106657,0.49301240714243716,0.9028032016079824,0.9492391497979504,0.9739492645573395
766,False,2007_002624,7681,146891,22842.0,146891,6755,130804,926,16087,23768.0,162978,0.28420565466173003,0.2957142231755899,0.8025868522131822,0.8904773575143643
767,False,2007_002624,22762,131810,22803.0,131810,5060,114067,17702,17743,40505.0,149553,0.12492284903098383,0.2218908963339765,0.7627195709882115,0.8653830105226422
768,True,2007_002643,2351,157649,0.0,157649,0,157649,2351,0,2351.0,157649,0.0,0.0,1.0,0.9999936568347605
769,True,2007_002728,21604,138396,0.0,138396,0,138396,21604,0,21604.0,138396,0.0,0.0,1.0,0.9999927744098499
770,True,2007_002823,15534,144466,0.0,144466,0,144466,15534,0,15534.0,144466,0.0,0.0,1.0,0.9999930780039732
771,False,2007_002823,4847,150432,7824.0,150432,2954,145562,1893,4870,9717.0,155302,0.3040032931974889,0.37750798722044726,0.9372834863684949,0.9676201365391902
772,False,2007_002824,79919,42642,81127.0,42642,79680,41195,239,1447,81366.0,44089,0.979278814246737,0.9821516615718371,0.9343600444555331,0.9660436648453439
773,True,2007_002852,0,160000,0.0,160000,0,160000,0,0,0.0,160000,0.0,0.0,1.0,0.9999937500390622
774,False,2007_003011,15414,136832,9144.0,136832,0,127688,15414,9144,24558.0,145976,0.0,0.0,0.8747191319120952,0.9331667068616488
775,False,2007_003020,4238,141991,47290.0,141991,4238,98939,0,43052,47290.0,185043,0.08961725523366462,0.08961536021653169,0.5346811281702091,0.6967927770578625
776,False,2007_003022,20365,131488,16384.0,131488,15593,130697,4772,791,21156.0,132279,0.7370485914161468,0.9516631064998474,0.9880404296978357,0.9939766824601297
777,True,2007_003022,23814,136186,0.0,136186,0,136186,23814,0,23814.0,136186,0.0,0.0,1.0,0.9999926571552351
778,False,2007_003088,22526,133210,45302.0,133210,21561,109469,965,23741,46267.0,156951,0.466012492705384,0.47592874644063304,0.6974724595574415,0.821771475328614
779,True,2007_003106,7834,152166,0.0,152166,0,152166,7834,0,7834.0,152166,0.0,0.0,1.0,0.9999934282728844
780,True,2007_003110,6831,153169,0.0,153169,0,153169,6831,0,6831.0,153169,0.0,0.0,1.0,0.9999934713063916
781,False,2007_003134,58667,90607,57422.0,90607,44330,77515,14337,13092,71759.0,103699,0.6177622319151604,0.7719903174686101,0.7474999758917636,0.8554984107363588
782,True,2007_003188,12027,147973,0.0,147973,0,147973,12027,0,12027.0,147973,0.0,0.0,1.0,0.9999932420560369
783,True,2007_003194,40082,119918,0.0,119918,0,119918,40082,0,40082.0,119918,0.0,0.0,1.0,0.9999916610378672
784,True,2007_003367,1983,158017,0.0,158017,0,158017,1983,0,1983.0,158017,0.0,0.0,1.0,0.9999936716070321
785,False,2007_003367,1587,147664,2140.0,147664,1266,146790,321,874,2461.0,148538,0.5144250304754165,0.5913124708080336,0.9882319675773202,0.9940744252192463
786,False,2007_003373,44360,66498,16512.0,66498,15145,65131,29215,1367,45727.0,67865,0.3312047586764931,0.9171561799794101,0.9597141383629264,0.979428262079129
787,False,2007_003373,61083,49775,14713.0,49775,2,35064,61081,14711,75794.0,64486,2.6387312979919254e-05,0.0001359249694168819,0.543745929349006,0.7044358727097396
788,True,2007_003530,9046,150954,0.0,150954,0,150954,9046,0,9046.0,150954,0.0,0.0,1.0,0.9999933755092577
789,False,2007_003621,5766,147750,4677.0,147750,3481,146554,2285,1196,6962.0,148946,0.5,0.7441214194100043,0.9839404884991876,0.9918985319896312
790,True,2007_003742,38352,121648,50320.0,121648,13157,84485,25195,37163,75515.0,158811,0.1742302853737668,0.26146141769837644,0.5319845602634579,0.6944981052043173
791,False,2007_003742,71843,82623,50320.0,82623,42284,74587,29559,8036,79879.0,90659,0.5293506428473066,0.840285367937839,0.8227203035550801,0.9027280209140202
792,False,2007_003872,2691,155654,2595.0,155654,2175,155234,516,420,3111.0,156074,0.6991321118611379,0.8378274268104776,0.9946179376449633,0.9972953005043205
793,False,2007_004033,16632,64317,26191.0,64317,16037,54163,595,10154,26786.0,74471,0.5987082804450086,0.6122861942577886,0.7273032455586739,0.8421126278802201
794,True,2007_004033,28118,131882,0.0,131882,0,131882,28118,0,28118.0,131882,0.0,0.0,1.0,0.9999924175215911
795,False,2007_004112,31807,119966,17711.0,119966,16542,118797,15265,1169,32976.0,121135,0.5016375545851528,0.9339430894308943,0.9806992198786478,0.9902473180124535
796,False,2007_004112,30111,121662,50234.0,121662,11272,82700,18839,38962,69073.0,160624,0.16318966890101777,0.2243853886732358,0.5148670186273533,0.6797465129086082
797,True,2007_004121,4001,155999,0.0,155999,0,155999,4001,0,4001.0,155999,0.0,0.0,1.0,0.9999935897435898
798,False,2007_004189,11648,140182,11700.0,140182,10341,138823,1307,1359,13007.0,141541,0.7950334435304067,0.8837706178959064,0.9807970835305672,0.990298395668519
799,False,2007_004275,35360,117115,37810.0,117115,34794,114099,566,3016,38376.0,120131,0.9066604127579737,0.9202084049615191,0.9497881479385004,0.9742392158202124
800,False,2007_004275,12564,139911,11837.0,139911,0,128074,12564,11837,24401.0,151748,0.0,0.0,0.8439913540870391,0.9153896735090629
801,False,2007_004281,3295,153611,3762.0,153611,3295,153144,0,467,3762.0,154078,0.8758639021796917,0.8756311453627424,0.9939381352302081,0.9969533630185142
802,True,2007_004380,36928,123072,0.0,123072,0,123072,36928,0,36928.0,123072,0.0,0.0,1.0,0.9999918747410074
803,True,2007_004380,46503,113497,0.0,113497,0,113497,46503,0,46503.0,113497,0.0,0.0,1.0,0.9999911892720577
804,False,2007_004392,12001,131981,21025.0,131981,11944,122900,57,9081,21082.0,141062,0.5665496632198084,0.5680585941215638,0.8712481036707264,0.9311875861859951
805,False,2007_004405,49486,96143,23410.0,96143,17350,90083,32136,6060,55546.0,102203,0.3123537248406726,0.7411046089445132,0.8814124829995206,0.9369591446164087
806,True,2007_004538,26517,133483,0.0,133483,0,133483,26517,0,26517.0,133483,0.0,0.0,1.0,0.9999925084654341
807,False,2007_004538,1213,149224,4820.0,149224,1213,145617,0,3607,4820.0,152831,0.2516597510373444,0.2516075503007675,0.9527975345316068,0.9758217456860445
808,True,2007_004644,15884,144116,0.0,144116,0,144116,15884,0,15884.0,144116,0.0,0.0,1.0,0.999993061193336
809,True,2007_004712,2492,157508,0.0,157508,0,157508,2492,0,2492.0,157508,0.0,0.0,1.0,0.9999936511564419
810,False,2007_004712,25034,121669,29933.0,121669,24824,116560,210,5109,30143.0,126778,0.823541120658196,0.8292911071022917,0.9194024199782297,0.9580011506534067
811,False,2007_004722,3013,149596,3406.0,149596,2130,148320,883,1276,4289.0,150872,0.49661925856843087,0.625183445846786,0.9830849992046238,0.9914637325614819
812,False,2007_004722,14983,137626,16460.0,137626,14368,135534,615,2092,17075.0,139718,0.8414641288433382,0.8728509811068587,0.9700539658454888,0.9847922282691624
813,True,2007_004902,25354,134646,0.0,134646,0,134646,25354,0,25354.0,134646,0.0,0.0,1.0,0.9999925731728149
814,True,2007_004902,43440,116560,0.0,116560,0,116560,43440,0,43440.0,116560,0.0,0.0,1.0,0.9999914208011256
815,False,2007_005114,14298,139048,4236.0,139048,4173,138985,10125,63,14361.0,139111,0.2905786505118028,0.9848949728581543,0.9990942484778342,0.9995397305985659
816,False,2007_005114,12113,141233,3194.0,141233,2746,140785,9367,448,12561.0,141681,0.21861316774142187,0.8594679186228482,0.9936759339643283,0.9968208788252121
817,True,2007_005149,73661,86339,0.0,86339,0,86339,73661,0,73661.0,86339,0.0,0.0,1.0,0.999988417882789
818,False,2007_005173,64065,70955,36501.0,70955,36001,70455,28064,500,64565.0,71455,0.5575931232091691,0.9862747246726207,0.9860051780841089,0.9929392863182818
819,False,2007_005173,4052,130968,51429.0,130968,2526,82065,1526,48903,52955.0,179871,0.04770087810405061,0.04911530235271242,0.456243641276248,0.626598660751781
820,False,2007_005281,4252,147953,7686.0,147953,3892,144159,360,3794,8046.0,151747,0.4837186179468059,0.5063093534538832,0.9499957165545283,0.9743501358530354
821,False,2007_005304,62314,91439,78865.0,91439,50430,63004,11884,28435,90749.0,119874,0.5557086028496182,0.6394390485126671,0.5255851977910139,0.6890201224846895
822,True,2007_005331,24131,135869,0.0,135869,0,135869,24131,0,24131.0,135869,0.0,0.0,1.0,0.9999926400235519
823,True,2007_005331,21684,138316,0.0,138316,0,138316,21684,0,21684.0,138316,0.0,0.0,1.0,0.999992770230702
824,False,2007_005354,33889,118602,37259.0,118602,32802,114145,1087,4457,38346.0,123059,0.8554216867469879,0.880354267310789,0.9275632013912026,0.9624124178983668
825,False,2007_005354,31038,121453,6972.0,121453,5659,120140,25379,1313,32351.0,122766,0.17492504095700287,0.8115588699268608,0.978609712786928,0.9891810891366278
826,True,2007_005509,11932,148068,0.0,148068,0,148068,11932,0,11932.0,148068,0.0,0.0,1.0,0.9999932463918849
827,True,2007_005547,18283,141717,0.0,141717,0,141717,18283,0,18283.0,141717,0.0,0.0,1.0,0.9999929437333296
828,True,2007_005608,38388,121612,18990.0,121612,17377,119999,21011,1613,40001.0,123225,0.4344141396465088,0.9150123742825549,0.9738202475147089,0.9867283925238256
829,True,2007_005608,37782,122218,20612.0,122218,18980,120586,18802,1632,39414.0,123850,0.4815547774902319,0.9207781497113472,0.9736455389584174,0.9866387386576555
830,False,2007_005696,72065,82501,66365.0,82501,66167,82303,5898,198,72263.0,82699,0.9156414762741653,0.9970014766597354,0.9952115503210438,0.997587937262127
831,True,2007_005759,3633,156367,841.0,156367,0,155526,3633,841,4474.0,157208,0.0,0.0,0.9893007989415297,0.9946152665507009
832,False,2007_005803,22391,133234,14456.0,133234,12883,131661,9508,1573,23964.0,134807,0.5375980637623101,0.8911254063775333,0.9766629329337497,0.9881862873869479
833,False,2007_005844,47353,98217,12512.0,98217,10600,96305,36753,1912,49265.0,100129,0.21516289454988327,0.8471189962439063,0.9618092660467996,0.9805229184059948
834,True,2007_005845,88565,71435,0.0,71435,0,71435,88565,0,88565.0,71435,0.0,0.0,1.0,0.9999860014558486
835,True,2007_006028,1847,158153,0.0,158153,0,158153,1847,0,1847.0,158153,0.0,0.0,1.0,0.9999936770489523
836,True,2007_006076,34916,125084,0.0,125084,0,125084,34916,0,34916.0,125084,0.0,0.0,1.0,0.9999920054363033
837,True,2007_006086,8820,151180,0.0,151180,0,151180,8820,0,8820.0,151180,0.0,0.0,1.0,0.9999933854121881
838,True,2007_006117,117248,42752,0.0,42752,0,42752,117248,0,117248.0,42752,0.0,0.0,1.0,0.9999766098285501
839,True,2007_006171,70064,89936,0.0,89936,0,89936,70064,0,70064.0,89936,0.0,0.0,1.0,0.9999888811056629
840,True,2007_006171,47298,112702,38456.0,112702,36555,110801,10743,1901,49199.0,114603,0.7430029065631415,0.9505421639753491,0.9668246031953789,0.9831237855247864
841,True,2007_006241,3496,156504,0.0,156504,0,156504,3496,0,3496.0,156504,0.0,0.0,1.0,0.9999936104277819
842,False,2007_006364,50692,97904,44878.0,97904,43245,96271,7447,1633,52325.0,99537,0.8264691829909221,0.9635909891040353,0.9671880808141696,0.9833103518717123
843,True,2007_006364,42303,117697,0.0,117697,0,117697,42303,0,42303.0,117697,0.0,0.0,1.0,0.999991503678907
844,False,2007_006373,3756,152451,3857.0,152451,3504,152098,252,353,4109.0,152804,0.8527622292528596,0.9082426127527217,0.9953797021020392,0.9976779576522447
845,True,2007_006444,2275,157725,0.0,157725,0,157725,2275,0,2275.0,157725,0.0,0.0,1.0,0.9999936598912037
846,False,2007_006444,7974,147787,11122.0,147787,621,137286,7353,10501,18475.0,158288,0.03361299052774019,0.05583026162006653,0.8673178004649752,0.9289387501014967
847,True,2007_006560,675,159325,0.0,159325,0,159325,675,0,675.0,159325,0.0,0.0,1.0,0.9999937235604986
848,True,2007_006647,38623,121377,26297.0,121377,19384,114464,19239,6913,45536.0,128290,0.42568517217146873,0.7370902730245646,0.8922285447034063,0.9430374532452339
849,True,2007_006647,57630,102370,0.0,102370,0,102370,57630,0,57630.0,102370,0.0,0.0,1.0,0.999990231608561
850,True,2007_006698,77007,82993,0.0,82993,0,82993,77007,0,77007.0,82993,0.0,0.0,1.0,0.9999879509362123
851,False,2007_006802,82131,73096,2163.0,73096,2163,73096,79968,0,82131.0,73096,0.02633597545384812,0.9995378927911276,1.0,0.9999863195479979
852,False,2007_006841,6035,137930,5070.0,137930,3761,136621,2274,1309,7344.0,139239,0.5121187363834423,0.741668309998028,0.981197796594345,0.9905024976256244
853,False,2007_006864,13011,114627,64325.0,114627,12458,62760,553,51867,64878.0,166494,0.19202194888868337,0.19366974473774212,0.3769505207394861,0.5475102069302439
854,True,2007_006866,14580,145420,0.0,145420,0,145420,14580,0,14580.0,145420,0.0,0.0,1.0,0.9999931234140874
855,True,2007_006866,35394,124606,23143.0,124606,19861,121324,15533,3282,38676.0,127888,0.5135225979935878,0.8581489802972693,0.9486738396096585,0.973653165552497
856,True,2007_007007,11146,148854,0.0,148854,0,148854,11146,0,11146.0,148854,0.0,0.0,1.0,0.9999932820530046
857,False,2007_007007,21974,118678,50862.0,118678,21688,89504,286,29174,51148.0,147852,0.4240243997810276,0.4264003302990386,0.6053621188756324,0.7541688082980139
858,False,2007_007109,75446,75851,68562.0,75851,67599,74888,7847,963,76409.0,76814,0.8846994464002932,0.9859399384507679,0.9749264457000026,0.9872910404471866
859,False,2007_007109,18383,132914,26681.0,132914,1781,108014,16602,24900,43283.0,157814,0.04114779474620521,0.06674911925642756,0.6844386429594332,0.8126547041342211
860,True,2007_007195,39448,120552,0.0,120552,0,120552,39448,0,39448.0,120552,0.0,0.0,1.0,0.9999917048932835
861,True,2007_007203,35962,124038,0.0,124038,0,124038,35962,0,35962.0,124038,0.0,0.0,1.0,0.9999919380194938
862,True,2007_007211,20689,139311,0.0,139311,0,139311,20689,0,20689.0,139311,0.0,0.0,1.0,0.999992821867463
863,False,2007_007235,13513,131820,10739.0,131820,9961,131042,3552,778,14291.0,132598,0.6970121055209573,0.9274674115456238,0.9882652830359432,0.9940904711692371
864,False,2007_007417,31469,121291,26623.0,121291,19974,114642,11495,6649,38118.0,127940,0.5240044073665985,0.7502253605769231,0.8960606534312959,0.9451736305774494
865,True,2007_007493,13445,146555,0.0,146555,0,146555,13445,0,13445.0,146555,0.0,0.0,1.0,0.9999931766696689
866,True,2007_007498,55865,104135,0.0,104135,0,104135,55865,0,55865.0,104135,0.0,0.0,1.0,0.9999903971729277
867,False,2007_007498,40943,103646,74739.0,103646,29416,58323,11527,45323,86266.0,148969,0.3409918160109429,0.3935777361519936,0.3915109855070518,0.5627080378592724
868,True,2007_007651,9003,150997,0.0,150997,0,150997,9003,0,9003.0,150997,0.0,0.0,1.0,0.9999933773957271
869,False,2007_007651,22847,133711,12784.0,133711,10053,130980,12794,2731,25578.0,136442,0.39303307529908516,0.7863120844739929,0.959968338194984,0.979568026803877
870,True,2007_007688,77767,82233,0.0,82233,0,82233,77767,0,77767.0,82233,0.0,0.0,1.0,0.9999878395797359
871,False,2007_007748,15019,136005,13295.0,136005,13004,135714,2015,291,15310.0,136296,0.8493794905290659,0.9780385078219013,0.9957298820214826,0.9978530358954752
872,True,2007_007748,24473,135527,0.0,135527,0,135527,24473,0,24473.0,135527,0.0,0.0,1.0,0.9999926214509179
873,False,2007_007795,2486,137432,37595.0,137432,2346,102183,140,35249,37735.0,172681,0.06217039883397377,0.06240025534631344,0.5917443146611382,0.7435113837287988
874,False,2007_007810,54993,100514,117649.0,100514,54882,37747,111,62767,117760.0,163281,0.46604959239130433,0.46648533786655333,0.23117815300004288,0.3755359896532856
875,False,2007_007810,2646,152861,23856.0,152861,45,129050,2601,23811,26457.0,176672,0.001700873114865631,0.0018862388397535314,0.7304496468031154,0.8442255105912523
876,True,2007_007815,56619,103381,0.0,103381,0,103381,56619,0,56619.0,103381,0.0,0.0,1.0,0.9999903271362519
877,True,2007_007836,15594,144406,0.0,144406,0,144406,15594,0,15594.0,144406,0.0,0.0,1.0,0.999993075127937
878,True,2007_007849,6208,153792,0.0,153792,0,153792,6208,0,6208.0,153792,0.0,0.0,1.0,0.9999934977534738
879,True,2007_007996,19,159981,0.0,159981,0,159981,19,0,19.0,159981,0.0,0.0,1.0,0.9999937492967959
880,True,2007_008110,12603,147397,0.0,147397,0,147397,12603,0,12603.0,147397,0.0,0.0,1.0,0.9999932156474307
881,False,2007_008204,7370,148161,8084.0,148161,0,140077,7370,8084,15454.0,156245,0.0,0.0,0.896521488687638,0.9454313521685722
882,True,2007_008222,32611,127389,0.0,127389,0,127389,32611,0,32611.0,127389,0.0,0.0,1.0,0.999992150090274
883,True,2007_008256,15505,144495,0.0,144495,0,144495,15505,0,15505.0,144495,0.0,0.0,1.0,0.9999930793932011
884,True,2007_008256,43939,116061,0.0,116061,0,116061,43939,0,43939.0,116061,0.0,0.0,1.0,0.9999913839154935
885,True,2007_008260,27052,132948,0.0,132948,0,132948,27052,0,27052.0,132948,0.0,0.0,1.0,0.9999924783187538
886,True,2007_008374,0,160000,0.0,160000,0,160000,0,0,0.0,160000,0.0,0.0,1.0,0.9999937500390622
887,False,2007_008415,18136,137318,16926.0,137318,16471,136863,1665,455,18591.0,137773,0.8859663277930181,0.9730607904531222,0.9933949322436181,0.9966792650689271
888,True,2007_008430,3145,156855,0.0,156855,0,156855,3145,0,3145.0,156855,0.0,0.0,1.0,0.9999936247258632
889,True,2007_008596,18871,141129,0.0,141129,0,141129,18871,0,18871.0,141129,0.0,0.0,1.0,0.9999929143343017
890,True,2007_008596,13872,146128,11570.0,146128,11045,145603,2827,525,14397.0,146653,0.7671737167465444,0.9545415262293665,0.9928402419316346,0.996400440706499
891,True,2007_008708,7,159993,0.0,159993,0,159993,7,0,7.0,159993,0.0,0.0,1.0,0.9999937497656162
892,True,2007_008802,22392,137608,0.0,137608,0,137608,22392,0,22392.0,137608,0.0,0.0,1.0,0.9999927330334498
893,False,2007_008897,13518,138397,23952.0,138397,13476,127921,42,10476,23994.0,148873,0.5616404101025256,0.5626017617834926,0.8592625929483519,0.9242980389890028
894,True,2007_008944,105139,54861,0.0,54861,0,54861,105139,0,105139.0,54861,0.0,0.0,1.0,0.9999817724472312
895,False,2007_008964,63733,88923,68681.0,88923,63068,83310,665,5613,69346.0,94536,0.9094684624924293,0.9182609708511692,0.8812515866971312,0.9368674373622419
896,False,2007_008964,60599,92057,21270.0,92057,2700,73487,57899,18570,79169.0,110627,0.03410425797976481,0.1269333834798552,0.6642772560044112,0.7982684829129462
897,False,2007_008980,42727,112476,38509.0,112476,38255,112222,4472,254,42981.0,112730,0.8900444382401527,0.9933783432874578,0.9954936574115142,0.9977328698311655
898,False,2007_009068,6720,143551,16808.0,143551,3992,130735,2728,12816,19536.0,156367,0.20434070434070434,0.2374918198584092,0.8360779448349076,0.9107152808738297
899,False,2007_009084,9999,133491,9886.0,133491,8430,132035,1569,1456,11455.0,134947,0.7359231776516805,0.852634772934156,0.9784211579360786,0.9890854882689599
900,True,2007_009084,7560,152440,9886.0,152440,5051,147605,2509,4835,12395.0,157275,0.40750302541347316,0.510872863355922,0.9385153393737085,0.9682762511397852
901,False,2007_009251,19335,134264,14423.0,134264,13157,132998,6178,1266,20601.0,135530,0.6386583175574001,0.9121602884082085,0.9813177894193168,0.9905634379771348
902,False,2007_009251,14091,139508,3115.0,139508,2986,139379,11105,129,14220.0,139637,0.20998593530239099,0.9582798459563543,0.9981523521702701,0.9990681604771018
903,True,2007_009258,97653,62347,0.0,62347,0,62347,97653,0,97653.0,62347,0.0,0.0,1.0,0.9999839609931354
904,False,2007_009320,35651,115828,35357.0,115828,31761,112232,3890,3596,39247.0,119424,0.8092593064438046,0.8982691328695062,0.9397775991425509,0.9689456008426215
905,False,2007_009331,7879,143613,8140.0,143613,6884,142357,995,1256,9135.0,144869,0.7535851122058018,0.8455963640830365,0.9826601964533475,0.9912473714261841
906,True,2007_009331,12360,147640,8140.0,147640,7479,146979,4881,661,13021.0,148301,0.5743798479379464,0.9186832084510502,0.991085697331778,0.9955161506627562
907,False,2007_009331,6616,144876,8121.0,144876,6175,142930,441,1946,8562.0,146822,0.7212099976640972,0.7602807190347205,0.9734917110514772,0.986561013825521
908,True,2007_009413,27741,132259,0.0,132259,0,132259,27741,0,27741.0,132259,0.0,0.0,1.0,0.9999924391350371
909,True,2007_009413,27741,132259,0.0,132259,0,132259,27741,0,27741.0,132259,0.0,0.0,1.0,0.9999924391350371
910,False,2007_009521,7125,149157,3932.0,149157,3591,148816,3534,341,7466.0,149498,0.48098044468256096,0.9130434782608695,0.9954380660610844,0.9977071293527668
911,False,2007_009562,65854,89286,69022.0,89286,65726,85990,128,3296,69150.0,92582,0.9504844540853218,0.9522333135331701,0.9287982545203172,0.963074131732503
912,False,2007_009592,30866,123302,26405.0,123302,26247,123144,4619,158,31024.0,123460,0.8460224342444559,0.993978641217905,0.9974404665478698,0.9987104936619547
913,False,2007_009654,37643,117789,79549.0,117789,36736,74976,907,42813,80456.0,160602,0.45659739484935863,0.46179761156505345,0.46684350132625996,0.6365226250106121
914,True,2007_009655,109521,50479,0.0,50479,0,50479,109521,0,109521.0,50479,0.0,0.0,1.0,0.9999801901743265
915,True,2007_009684,3398,156602,0.0,156602,0,156602,3398,0,3398.0,156602,0.0,0.0,1.0,0.9999936144262881
916,True,2007_009687,1813,158187,0.0,158187,0,158187,1813,0,1813.0,158187,0.0,0.0,1.0,0.9999936784079703
917,True,2007_009691,12396,147604,0.0,147604,0,147604,12396,0,12396.0,147604,0.0,0.0,1.0,0.9999932251617493
918,True,2007_009691,36980,123020,0.0,123020,0,123020,36980,0,36980.0,123020,0.0,0.0,1.0,0.9999918713065249
919,True,2007_009706,2421,157579,0.0,157579,0,157579,2421,0,2421.0,157579,0.0,0.0,1.0,0.9999936540170072
920,True,2007_009750,240,159760,0.0,159760,0,159760,240,0,240.0,159760,0.0,0.0,1.0,0.999993740650096
921,False,2007_009756,37501,116652,23293.0,116652,23229,116588,14272,64,37565.0,116716,0.6183681618527885,0.997209581866575,0.9989033208814558,0.9994427918699048
922,True,2007_009756,33436,126564,0.0,126564,0,126564,33436,0,33436.0,126564,0.0,0.0,1.0,0.9999920989215028
923,False,2007_009841,9583,144874,9409.0,144874,9018,144483,565,391,9974.0,145265,0.9041507920593543,0.9583421891604675,0.9946167349327092,0.9972942191544435
924,False,2007_009938,16966,136156,14450.0,136156,13287,134993,3679,1163,18129.0,137319,0.7329141155055436,0.9194519410421425,0.9830613389261501,0.9914510454842571
925,False,2008_000080,11953,143724,14810.0,143724,11843,140757,110,2967,14920.0,146691,0.7937667560321716,0.7996083991627844,0.9595476205084157,0.9793494520786223
926,True,2008_000213,62056,97944,0.0,97944,0,97944,62056,0,62056.0,97944,0.0,0.0,1.0,0.999989790188371
927,True,2008_000215,71123,88877,0.0,88877,0,88877,71123,0,71123.0,88877,0.0,0.0,1.0,0.9999887486217062
928,True,2008_000223,17780,142220,0.0,142220,0,142220,17780,0,17780.0,142220,0.0,0.0,1.0,0.9999929686895747
929,False,2008_000233,22482,133749,29646.0,133749,22443,126546,39,7203,29685.0,140952,0.7560384032339565,0.7570074543798698,0.8977949940405244,0.9461383177570093
930,False,2008_000234,31054,122420,91407.0,122420,31054,62067,0,60353,91407.0,182773,0.3397332808209437,0.33972956415193417,0.33958516848768694,0.5069963486656701
931,False,2008_000239,19291,138186,20080.0,138186,19150,137256,141,930,20221.0,139116,0.9470352603728797,0.9536377670434739,0.9866298628482705,0.9932627526467758
932,True,2008_000270,10131,149869,0.0,149869,0,149869,10131,0,10131.0,149869,0.0,0.0,1.0,0.9999933275505438
933,False,2008_000270,12931,135965,37875.0,135965,8897,106987,4034,28978,41909.0,164943,0.21229330215466846,0.23489808849931354,0.6486301328337668,0.7868658341055852
934,False,2008_000271,16488,140360,30779.0,140360,9470,119051,7018,21309,37797.0,161669,0.2505489853692092,0.3076673164392463,0.7363873098738781,0.8481772002194342
935,True,2008_000359,37276,122724,0.0,122724,0,122724,37276,0,37276.0,122724,0.0,0.0,1.0,0.9999918517009574
936,True,2008_000474,10304,149696,0.0,149696,0,149696,10304,0,10304.0,149696,0.0,0.0,1.0,0.999993319839409
937,False,2008_000510,7049,148268,10398.0,148268,6536,144406,513,3862,10911.0,152130,0.5990285033452479,0.6285219732666603,0.9492276342601722,0.9739460035476061
938,True,2008_000573,2340,157660,0.0,157660,0,157660,2340,0,2340.0,157660,0.0,0.0,1.0,0.9999936572773228
939,False,2008_000573,15038,129522,79701.0,129522,15021,64842,17,64680,79718.0,194202,0.18842670413206553,0.18846453037564928,0.3338894553094201,0.5006215112373864
940,True,2008_000602,56591,103409,0.0,103409,0,103409,56591,0,56591.0,103409,0.0,0.0,1.0,0.9999903297553429
941,False,2008_000630,12517,142041,12936.0,142041,12098,141203,419,838,13355.0,142879,0.9058779483339573,0.9351472520677128,0.9882697947214076,0.9940932963489673
942,False,2008_000661,21126,131056,20996.0,131056,20682,130742,444,314,21440.0,131370,0.9646455223880597,0.9849978568366909,0.995219608738677,0.9975964656599801
943,False,2008_000661,11464,140718,23033.0,140718,6367,124052,5097,16666,28130.0,157384,0.22634198364735159,0.27641746982721194,0.7882122706247141,0.8815582828189512
944,False,2008_000662,7572,145770,23414.0,145770,405,122761,7167,23009,30581.0,168779,0.013243517216572381,0.01729660474055093,0.7273475965611835,0.842149673117424
945,True,2008_000666,693,159307,0.0,159307,0,159307,693,0,693.0,159307,0.0,0.0,1.0,0.999993722851332
946,False,2008_000673,45479,99810,40433.0,99810,26679,86056,18800,13754,59233.0,113564,0.45040771191734336,0.6598159964386408,0.7577753513437356,0.8621895382272495
947,False,2008_000700,11329,144211,13532.0,144211,11104,141783,225,2428,13757.0,146639,0.8071527222504906,0.8205128205128205,0.9668846623340311,0.9831567414639558
948,False,2008_000725,5871,147942,3370.0,147942,2482,147054,3389,888,6759.0,148830,0.3672140849238053,0.7362800355977455,0.988066921991534,0.9939909289388481
949,True,2008_000731,114149,45851,0.0,45851,0,45851,114149,0,114149.0,45851,0.0,0.0,1.0,0.9999781907005147
950,True,2008_000763,364,159636,0.0,159636,0,159636,364,0,364.0,159636,0.0,0.0,1.0,0.9999937357880692
951,False,2008_000763,8149,148137,6175.0,148137,395,142357,7754,5780,13929.0,153917,0.028358101801995834,0.06395725388601037,0.9248945860431271,0.9609755768270126
952,False,2008_000765,74522,82877,14522.0,82877,14522,82877,60000,0,74522.0,82877,0.19486862939803012,0.9999311437030917,1.0,0.9999879340717681
953,True,2008_000782,44977,115023,0.0,115023,0,115023,44977,0,44977.0,115023,0.0,0.0,1.0,0.9999913061621922
954,True,2008_000795,29,159971,0.0,159971,0,159971,29,0,29.0,159971,0.0,0.0,1.0,0.9999937489060585
955,False,2008_000811,62297,87148,41181.0,87148,40597,86564,21700,584,62881.0,87732,0.6456163228956282,0.9857947647030256,0.9866867277618201,0.9932873584321106
956,False,2008_000811,64283,85162,16725.0,85162,16069,84506,48214,656,64939.0,85818,0.2474476046751567,0.960719837378931,0.9847118320165933,0.992285382149525
957,True,2008_000863,21224,138776,0.0,138776,0,138776,21224,0,21224.0,138776,0.0,0.0,1.0,0.9999927941950035
958,True,2008_000943,111783,48217,0.0,48217,0,48217,111783,0,111783.0,48217,0.0,0.0,1.0,0.9999792608569414
959,True,2008_000992,65869,94131,0.0,94131,0,94131,65869,0,65869.0,94131,0.0,0.0,1.0,0.9999893766200655
960,False,2008_001013,4359,136670,3604.0,136670,2143,135209,2216,1461,5820.0,138131,0.368213058419244,0.5944521497919556,0.9788461677682779,0.9893027782045936
961,True,2008_001028,19316,140684,0.0,140684,0,140684,19316,0,19316.0,140684,0.0,0.0,1.0,0.999992891921669
962,True,2008_001070,15590,144410,0.0,144410,0,144410,15590,0,15590.0,144410,0.0,0.0,1.0,0.9999930753197471
963,False,2008_001074,33463,121486,41966.0,121486,28165,107685,5298,13801,47264.0,135287,0.5959080907244414,0.6711225486691924,0.7959744838750212,0.8863911365002016
964,True,2008_001076,18555,141445,0.0,141445,0,141445,18555,0,18555.0,141445,0.0,0.0,1.0,0.9999929301641616
965,False,2008_001150,3188,155481,3029.0,155481,2955,155407,233,74,3262.0,155555,0.9058859595340282,0.9752475247524752,0.9990485680306002,0.999517629050308
966,True,2008_001170,34993,125007,0.0,125007,0,125007,34993,0,34993.0,125007,0.0,0.0,1.0,0.9999920005119672
967,False,2008_001231,4903,150246,3826.0,150246,3574,149994,1329,252,5155.0,150498,0.6933074684772066,0.9338907760648028,0.9966511182872863,0.9983161061452143
968,False,2008_001249,30650,125681,32930.0,125681,30580,123331,70,2350,33000.0,128031,0.9266666666666666,0.9286083022076463,0.9632901406690567,0.9812940596107637
969,True,2008_001283,36223,123777,0.0,123777,0,123777,36223,0,36223.0,123777,0.0,0.0,1.0,0.9999919210198904
970,True,2008_001308,26824,133176,0.0,133176,0,133176,26824,0,26824.0,133176,0.0,0.0,1.0,0.9999924911959273
971,False,2008_001379,30759,126018,26581.0,126018,22595,122032,8164,3986,34745.0,130004,0.6503093970355447,0.8500112858325183,0.9386788098827729,0.9683619136796833
972,True,2008_001404,13005,146995,0.0,146995,0,146995,13005,0,13005.0,146995,0.0,0.0,1.0,0.9999931970937985
973,True,2008_001478,64900,95100,0.0,95100,0,95100,64900,0,64900.0,95100,0.0,0.0,1.0,0.999989484863461
974,True,2008_001491,31340,128660,0.0,128660,0,128660,31340,0,31340.0,128660,0.0,0.0,1.0,0.9999922276369685
975,True,2008_001504,11425,148575,0.0,148575,0,148575,11425,0,11425.0,148575,0.0,0.0,1.0,0.9999932694378635
976,False,2008_001531,25090,126553,16898.0,126553,16805,126460,8285,93,25183.0,126646,0.6673152523527777,0.9944375406828806,0.9985313393237845,0.9992572340660903
977,False,2008_001547,10338,147416,10112.0,147416,9716,147020,622,396,10734.0,147812,0.9051611701136575,0.9607435973499456,0.9946418423402701,0.9973069591702449
978,False,2008_001629,41887,113784,46735.0,113784,41764,108813,123,4971,46858.0,118755,0.8912885739895002,0.8936152002738789,0.9162814197296956,0.9563035549501252
979,False,2008_001682,8624,148360,9525.0,148360,8593,147428,31,932,9556.0,149292,0.8992256174131436,0.9020575267688432,0.9875144013075048,0.9937112853108296
980,True,2008_001821,57775,102225,0.0,102225,0,102225,57775,0,57775.0,102225,0.0,0.0,1.0,0.9999902177528222
981,True,2008_001874,8277,151723,0.0,151723,0,151723,8277,0,8277.0,151723,0.0,0.0,1.0,0.9999934090849173
982,True,2008_001895,83866,76134,0.0,76134,0,76134,83866,0,83866.0,76134,0.0,0.0,1.0,0.9999868654363959
983,True,2008_001895,118286,41714,0.0,41714,0,41714,118286,0,118286.0,41714,0.0,0.0,1.0,0.999976027807743
984,True,2008_001992,2828,157172,0.0,157172,0,157172,2828,0,2828.0,157172,0.0,0.0,1.0,0.9999936375840635
985,False,2008_001992,63905,87259,37220.0,87259,19281,69320,44624,17939,81844.0,105198,0.23558232735447926,0.5180140243410978,0.658947888743132,0.7944075177630071
986,True,2008_002212,50374,109626,0.0,109626,0,109626,50374,0,50374.0,109626,0.0,0.0,1.0,0.9999908781595774
987,True,2008_002239,29852,130148,0.0,130148,0,130148,29852,0,29852.0,130148,0.0,0.0,1.0,0.9999923164987822
988,False,2008_002240,49176,89973,79443.0,89973,45628,56158,3548,33815,82991.0,123788,0.5497945560361966,0.5743416746387392,0.4536627136717614,0.6241580901149221
989,True,2008_002241,2268,157732,0.0,157732,0,157732,2268,0,2268.0,157732,0.0,0.0,1.0,0.9999936601725701
990,False,2008_002379,16554,133051,32020.0,133051,10210,111241,6344,21810,38364.0,154861,0.26613491815243456,0.3188532525530121,0.7183280490246091,0.8360716110994197
991,False,2008_002383,30241,122379,32005.0,122379,29951,120325,290,2054,32295.0,124433,0.9274191051246323,0.9357932887583578,0.966986249628314,0.9832080405294983
992,True,2008_002495,100,159900,0.0,159900,0,159900,100,0,100.0,159900,0.0,0.0,1.0,0.9999937461304182
993,True,2008_002536,22627,137373,0.0,137373,0,137373,22627,0,22627.0,137373,0.0,0.0,1.0,0.9999927206021518
994,True,2008_002588,130952,29048,0.0,29048,0,29048,130952,0,130952.0,29048,0.0,0.0,1.0,0.9999655754070708
995,False,2008_002775,359,152804,45688.0,152804,250,107366,109,45438,45797.0,198242,0.005458872851933532,0.005471776576418831,0.5415905812088255,0.7026340761100749
996,True,2008_002775,771,159229,0.0,159229,0,159229,771,0,771.0,159229,0.0,0.0,1.0,0.999993719776424
997,False,2008_002835,27157,127933,23802.0,127933,22473,126604,4684,1329,28486.0,129262,0.788913852418732,0.9441246901651053,0.9794371122216893,0.9896040145700127
998,False,2008_002835,24280,130810,7976.0,130810,7282,130116,16998,694,24974.0,131504,0.29158324657643947,0.9128745142284067,0.9894451879790729,0.9946869911551781
999,False,2008_002859,43060,102526,44226.0,102526,41826,100126,1234,2400,45460.0,104926,0.920061592608887,0.9457118954484817,0.9542534738768275,0.9765817784583574
